id	text
es_308Q0PEVBAQE096ZB2OQPF9BDIFI93	J'aurais besoin de connaître la quantité de vinaigre utilisée dans les récipients et peut-être les conditions de la pièce (par exemple, le taux d'humidité). J'aurais également besoin de savoir quel instrument a été utilisé pour déterminer la masse.
es_30LB5CDZNENIZ57WBATJWZB8AAAZ0Y	Il serait intéressant de connaître la densité du matériau, la température à laquelle l'expérience a été menée, et d'inclure un groupe témoin avec uniquement de l'eau, afin de pouvoir faire une comparaison avec l'eau vinaigrée qui est une eau acide.
es_30ZX6P7VFA8ZV0568BUBRTGXN4EJ21	concentration de vinaigre, température et type de vinaigre
es_3137ONMDKIIHZERLTP49WHX6SNOEGB	marbre
es_31LM9EDVON5VKMUZUUSVJHJV3MFNJL	1. j'aurais besoin de savoir quel type de bois, de plastique, etc. a été utilisé dans l'expérience. 2. J'aurais besoin de savoir quel vinaigre a été utilisé par l'étudiant3. J'aurais besoin de savoir si la masse initiale affectera les résultats finaux afin de savoir si je dois utiliser les mêmes masses initiales.
es_31LM9EDVON5VKMUZUUSVJHJVVCBJNL	1) En plus du vinaigre, nous avons besoin d'un autre milieu de référence acide pour mesurer la réaction des matériaux au vinaigre. On suggère d'utiliser du jus de citron, car c'est un milieu acide que l'on peut manipuler sans danger. Testons les mêmes matériaux dans du jus de citron que dans du vinaigre. \n2. Nous avons besoin d'un milieu de référence neutre pour mesurer l'influence de la pluie non acide sur les matériaux. L'eau du robinet peut être utilisée pour cela. Le niveau de pH peut être mesuré et, si nécessaire, un peu d'acide ou d'hydroxyde peut être ajouté jusqu'à ce que le pH soit neutre. Ajoutez des échantillons de ces quatre matières dans de l'eau neutre, comme on l'a fait pour le vinaigre et comme on le ferait pour le jus de citron. Une donnée nécessaire pour mesurer la résistance du matériau aux pluies acides est le pourcentage de dégradation au milieu acide, qui serait la masse finale moins la masse initiale et la différence de cette soustraction est divisée par la masse initiale et multipliée par 100. Pour garantir une mesure correcte de la masse, il est recommandé d'utiliser une balance manuelle plutôt qu'une balance électronique.
es_31Q0U3WYDRSZMKM8OY50JK1J18B71J	Utilisez une balance de haute précision pour obtenir des résultats de mesure précis. \Pour les matériaux tels que le calcaire ou le marbre, n'utilisez pas de trop petits échantillons car ils peuvent se dissoudre complètement au contact du vinaigre après _24 heures. Pour le séchage, les échantillons doivent reposer dans un environnement sec pour éviter la réabsorption de l'humidité.
es_31Q0U3WYDRSZMKM8OY50JK1J19S712	J'aurais besoin de plus d'échantillons, de leur masse initiale et de la différence entre les masses.
es_31Q0U3WYDRSZMKM8OY50JK1J1IW71O	Le groupe doit indiquer le type de bois et de plastique utilisé, car il existe différents types de bois provenant de différentes espèces d'arbres et des plastiques d'élasticité différente (comme le PVC). La température de l'environnement doit être déclarée et contrôlée afin que l'expérience puisse être répétée. La marque du vinaigre doit également être déclarée.
es_31QNSG6A5T6HXK6TNJEFYUORPHQ78S	Pour reproduire l'expérience, vous devez connaître les conditions environnementales dans lesquelles l'expérience a été menée. n Vous devez également connaître le type de vinaigre utilisé dans l'expérience (acidité). n Vous devez également connaître le type de matériau d'échantillon utilisé. Par exemple, le calcaire utilisé pourrait être composé d'une proportion différente de minéraux et les résultats pourraient varier, tout comme l'utilisation d'un autre type de bois ou de plastique, etc.
es_31Z0PCVWUMS0V4YHQHPAPQKET7DT7L	L'élève doit mesurer le poids de l'échantillon avant qu'il ne se dépose pendant _30 minutes et ne sèche, puis mesurer à nouveau le poids après que les échantillons se sont déposés pendant 30 minutes et ont séché.
es_31Z0PCVWUMS0V4YHQHPAPQKEYRV7TQ	L'expérience est complète et ne nécessite aucune information supplémentaire. Les tests supplémentaires à effectuer seraient une tare du liquide extrait et une dilution du liquide extrait pour vérifier la présence de matériau corrodé.
es_320DUZ38G9ZPAUDD7QF0TXAYUSNJGV	Il faudrait connaître la taille du récipient, le matériau dont il est fait et la quantité de vinaigre utilisée.
es_320DUZ38G9ZPAUDD7QF0TXAYYTGGJR	quantité de vinaigre, température du vinaigre, masse des échantillons
es_32AT8R96GNM1EFXYEPDVPD2C8JRUS7	Quelle quantité de vinaigre a été ajoutée à chaque échantillon ; où sur les échantillons le vinaigre a-t-il été appliqué ; les échantillons ont-ils un vernis ou des surfaces finies qui pourraient affecter la réaction avec le vinaigre ; quelle quantité de vinaigre a été ajoutée à chaque échantillon ; où sur les échantillons le vinaigre a-t-il été appliqué ; les échantillons ont-ils un vernis ou des surfaces finies qui pourraient affecter la réaction avec le vinaigre ?
es_32RIADZISUH2XH3JZJMDC94I3YQS4J	La quantité de vinaigre ajoutée, si les échantillons ont été laissés dans l'obscurité ou exposés à la lumière, précisez le type de bois, de marbre, de calcaire et de plastique utilisé dans l'expérience.
es_32SCWG5HIJHJZCR5QQBYE2JL9RW6PE	Parmi les informations importantes, citons le type de vinaigre utilisé, la quantité de vinaigre dans chaque récipient et la température au moment de l'expérience.
es_32SVAV9L3HMDFPYLI5V3H4I601DA3P	Les pluies acides sont produites par l'interaction de certains gaz émis dans l'air par les industries (comme l'oxyde sulfureux et l'oxyde nitreux) qui se mélangent aux gouttes de pluie tombant dans l'atmosphère. _1) Comme il existe plus d'une substance qui produit de telles pluies acides, il est pratique de faire l'expérience en utilisant au moins un deuxième agent acide en plus du vinaigre. Cet agent pourrait être le jus d'un citron, également acide comme le vinaigre et sans danger à manipuler. On peut ensuite placer des échantillons des mêmes matériaux dans du jus de citron et répéter l'expérience et les mesures. 2) Il est également nécessaire d'avoir un élément au pH neutre (comme l'eau) pour comparer l'influence d'un environnement acide sur les surfaces avec l'influence d'un environnement neutre. Vous pouvez donc faire des échantillons des matériaux et les mettre dans des récipients avec de l'eau, comme vous l'avez fait avec le vinaigre et le jus de citron. 3) Une autre donnée de l'expérience qui serait utile est le pourcentage de dégradation quotidienne, qui est calculé comme la différence entre la masse initiale de chaque objet et la masse finale, diviser cette soustraction par la masse initiale et multiplier par 100. Comme la période de l'expérience est de 24 heures, ce pourcentage serait un taux quotidien. (4) Si une perte de masse se produit avec les objets immergés dans l'eau, cela pourrait indiquer que l'air sur le site de l'expérience est légèrement acide et le niveau d'acidité pourrait être mesuré en le comparant aux niveaux d'acidité des autres substances. 5) Il est important que, dans la mesure du possible, la masse des échantillons soit calculée avec une balance manuelle et non avec des balances électroniques.
es_32UTUBMZ7I92A85W8T15VAUV9E8VB5	Nous avons besoin de la densité de chaque élément testé. Quantité de vinaigre utilisée dans chaque échantillon, exprimée en volume. Aire ou surface du récipient utilisé,
es_32Z9ZLUT1NXHB1ZL79PNMT3L8PCOHQ	J'aurais besoin de savoir : -Type de vinaigre, s'il s'agit de vin, de pomme, etc. -Pourcentage d'acidité du vinaigre -Type d'eau distillée, pourcentage de pureté -Matériau des récipients -Litres de vinaigre et d'eau distillée nécessaires -Savoir le type de bois et de plastique.
es_32ZKVD547H0IYZ3DOJVZCF2CIJU3B9	Je vois que dans l'expérience, vous voulez voir comment les matériaux réagissent au vinaigre et quelle quantité de celui-ci se dissout. Je pense que l'expérience est très claire, peut-être devriez-vous préciser quelle taille de récipient est nécessaire, bien que tant que les _4 récipients sont les mêmes et que l'échantillon rentre, cela devrait suffire. Il serait également bon de savoir quelle quantité de vinaigre il faut ajouter. Les mesures ne sont pas données, je suppose donc que la quantité sera la même dans tous les récipients et qu'elle sera suffisante pour immerger l'échantillon. Enfin, vous pouvez spécifier la quantité d'eau distillée avec laquelle rincer les échantillons et pendant combien de temps.
es_333U7HK6IBSMYA3M50ESNC71PPZDJT	Selon ce tableau, quatre échantillons différents et leurs masses dans cette section la masse la plus élevée est le bois est _0,0 et la plus basse est le calcaire est -1,3 est très faible et le tableau entier est le plastique est -0,1 et le mormol est -0,4, donc le tableau entier contient la masse.
es_336KAV9KYS5PQP05UBVE1GVLZ7QY2A	Il faudrait connaître le type de bois pour reproduire cette expérience, surtout si un vernis pour bois a été utilisé. Une mesure supplémentaire doit être incluse pour indiquer le poids de l'échantillon humide, soit dans la solution de vinaigre, soit sur une balance immédiatement après l'extraction.
es_336YQZE83XRHV5UETR915SBQ9DJM50	la quantité de vinaigre ajoutée, la concentration de vinaigre utilisée, le type de plastique utilisé, le type de bois utilisé, l'état du marbre et de la pierre calcaire utilisés, la quantité d'eau distillée utilisée pour le rinçage, le temps de rinçage, le matériau du récipient dans lequel les échantillons sont placés.
es_338JKRMM28CS9X5KXQK5LYJGKREHAT	la quantité de vinaigre utilisée, la température de la pièce, le matériau du récipient, la température de séchage.
es_338JKRMM28CS9X5KXQK5LYJGQI0AHW	J'aurais besoin de savoir : la quantité de vinaigre à mettre sur les échantillons ; la quantité d'eau distillée à utiliser ; si je dois sécher les échantillons avec une serviette avant de les peser ; le type de bois ; le type de plastique ; le type de vinaigre ; le matériau du récipient.
es_33CID571066UB8PPFWKTQIYH2C23LW	volume, densité
es_33CID571066UB8PPFWKTQIYH3ACL3L	J'ai besoin d'un poids, de vinaigre et d'eau distillée pour reproduire l'expérience.
es_33F859I568QXS7AC34K1G93M1PNHB7	laissez-le sécher très bien tenez compte de la température
es_33FBRBDW6QCN911PE0MQEGG5GRR8CK	des matériaux différents ont des densités différentes
es_33JKGHPFYE7LLU0KXR5NZ9BC98QMNQ	nIl est nécessaire de faire le test dans d'autres types de solvants comme l'alcool, l'eau, entre autres. nTester avec d'autres méthodes comme la macération, entre autres.
es_33LK57MYLVII0ER8KCC365HRBJAZS6	Quelle quantité de vinaigre sera ajoutée aux récipients ? nQuel type de vinaigre sera utilisé pour la procédure ? nDoit-on couvrir les récipients ? nÀ quelle température doit-on laisser reposer les échantillons ?
es_33NF62TLXLFUCG9WXH0FRP2R7PNKJK	Déterminez la masse de chaque échantillon, mouillez chaque échantillon avec de l'eau distillée après _24 heures et étiquetez les récipients.
es_33OOO72IVJY67LTDHYXL5CCS5S2TC7	La quantité de vinaigre dans chaque récipient, la température ambiante et la température de l'eau distillée utilisée pour rincer chaque échantillon.
es_33PPO7FECXSQ3ZJGNITSBBS141VDIC	Quel type de bois a été utilisé pour l'expérience ? \N- Quel type de plastique a été utilisé pour l'expérience (souple ou dur) ? \N- Où les récipients d'échantillons ont-ils été stockés (température, endroit clair ou sombre) ?
es_33PPO7FECXSQ3ZJGNITSBBS14OCID8	J'aurais besoin de connaître la quantité de vinaigre, l'acidité du vinaigre, le matériau des récipients.
es_33PPO7FECXSQ3ZJGNITSBBS1CSDDIK	La quantité en mL de vinaigre qui a été versée sur les échantillons, des informations sur le type de récipient utilisé pour placer les échantillons et pour avoir des conditions précises dans lesquelles les échantillons sont travaillés (pression, atmosphère et température) et bien sûr avoir une balance pour calculer la masse des échantillons.
es_33PPO7FECXSQ3ZJGNITSBBS1FDQIDB	Quelle quantité de vinaigre faut-il utiliser ? Quelle quantité de matériau d'échantillon faut-il utiliser ? Combien de temps faut-il rincer l'échantillon ? Combien de temps faut-il rincer l'échantillon ? Faut-il sécher l'échantillon pendant _30 minutes à la fois ?
es_33TIN5LC06N0Q9L4FKATB33Z3PN9YM	Quelle quantité de vinaigre faut-il mettre dans les récipients ? Quelle sorte de vinaigre faut-il mettre dans les récipients ? Comment sécher l'échantillon s'il est encore humide après _30 minutes ?
es_34HJIJKLP79IP9KNTERINWOP1LX4VE	Pour reproduire l'expérience, j'ajouterais : - un poids pour mesurer précisément les échantillons avant et après l'expérience - décrire la forme des échantillons étudiés - déterminer la quantité spécifique de vinaigre à mettre dans chaque récipient, afin que chaque échantillon ait la même quantité - mentionner pourquoi ces échantillons sont choisis et quel est l'objectif.
es_34HJIJKLP79IP9KNTERINWOP8AFV48	1.2 - Prenez quatre récipients de même portion ou taille. n2.2 - Assurez-vous que la portion de vinaigre est la même dans tous les récipients. n2.3 - Prenez quatre échantillons de différents types de bois, nous les appellerons le matériau.
es_34J10VATJHBKS8NLS4ZCBAZ0QAGIQ9	Vous devrez connaître la quantité de vinaigre utilisée, s'il reste une masse résiduelle de l'échantillon et les ustensiles nécessaires/utilisés pour réaliser cette expérience (tenez également compte de la porosité de chaque échantillon et s'il est complètement sec).
es_34S6N1K2ZXW95GWOUH9VUCZRGO8LHI	Je dois savoir quelle quantité de vinaigre mettre dans chaque récipient, quel type de vinaigre, l'endroit dans lequel l'échantillon sèche pendant _30 minutes.
es_352YTHGROXQD78P3OPAE8VXG21I4HJ	Pour que l'expérience soit réussie et plus précise, il faut accorder plus d'importance aux récipients. Les béchers, par exemple, sont un bon exemple, car s'ils sont faits de différents types de plastique, on peut obtenir des données erronées.
es_358010RM5G69NB8XDPTNK7LNY0WVXM	Tout d'abord, l'expérience nécessite une liste d'outils. Il est également nécessaire de connaître précisément la quantité de vinaigre utilisée dans les récipients, ainsi que les instructions sur la façon de mesurer la masse des échantillons afin de pouvoir reproduire l'expérience.
es_358UUM7WR1GNFPLPMSKFPBJW5JWR7G	il est nécessaire de savoir en plus, _1.- quel type de bois a été utilisé. 2.- la densité du vinaigre. 3.- la température à laquelle les échantillons ont été soumis,
es_358UUM7WR1GNFPLPMSKFPBJW8E27RV	1. la quantité de vinaigre. 2. une balance. 3. comment sécher les matériaux.
es_358UUM7WR1GNFPLPMSKFPBJWE007R7	Quel est le pH du vinaigre ? Quelle est la forme des échantillons ? Y a-t-il un groupe de contrôle ?
es_35GCEFQ6I71EGX6TUXB2YX9FI233Z7	La quantité de vinaigre à placer dans chaque récipient, la taille ou le poids des échantillons à utiliser et les conditions dans lesquelles il faut laisser reposer les récipients.
es_35H6S234SCDF629M6B2KGWE4Q0656S	Après avoir lu la procédure des groupes, décrivez quelles informations supplémentaires sont nécessaires pour reproduire l'expérience.
es_35USIKEBNTTJWRFSABY6ADEQEZH6NJ	1. la taille des conteneurs. \n2. Quantité de vinaigre à verser dans chaque récipient. \n3. Comment déterminer la masse. \n4. Quel type de matériau. \n5. Taille et forme de chaque échantillon.
es_369J354OFFNDMZY6N7LBKT5TD72G6W	Servir les autres pâtes, le temps de repos de la nouvelle pâte et le temps de séchage des pâtes et la quantité d'eau distillée à utiliser.
es_36PW28KO419GPNEI7PCZ0VM3TDPAEE	Vous devez connaître la quantité de vinaigre à ajouter à l'échantillon. Vous devez également connaître la quantité de matériel d'échantillonnage à inclure.
es_36U2A8VAG3CK754VJH1I1CHFJOMKYT	1. quantité de vinaigre à ajouter aux récipients2. Quelle sera la quantité d'échantillons ? 3. Est-il séché à l'air ou au soleil ?
es_36U2A8VAG3CK754VJH1I1CHFMMQKYW	1. température ambiante (si le résultat peut être affecté par celle-ci)n2. Où mettre les échantillons à sécher n3. La température de l'eau distillée
es_36V4Q8R5ZMD6ORDCDJX4336H4ACQMO	-La quantité de vinaigre fournie à chaque échantillon. \Ÿ Les plastiques ont différents types, il est nécessaire de savoir quel type de plastique a été utilisé dans cette expérience.
es_36WLNQG781NL8XJAD3CVV669IV7EBH	Pour reproduire l'expérience, vous devez connaître le type de bois utilisé, le type de plastique utilisé et la quantité, le type et la concentration de vinaigre utilisés.
es_36ZN444YTTBH7WA5DR78M540GY5IOR	Données sur la situation géographique de l'expérience (altitude au-dessus du niveau de la mer) nQuantité de vinaigre utilisé nConditions de température de l'environnement
es_373ERPL3YQLADNIWZVNGU7BE4HLTR4	l'heure exacte de chaque récipient et le type de matériel qu'ils ont utilisé pour créer cette expérience, le nombre d'éléments utilisés pour créer cette expérience, le nombre d'éléments utilisés pour créer cette expérience, le nombre d'éléments utilisés pour créer cette expérience, le nombre d'éléments utilisés pour créer cette expérience, le nombre d'éléments utilisés pour créer cette expérience, le nombre d'éléments utilisés pour créer cette expérience, le nombre d'éléments utilisés pour créer cette expérience, le nombre d'éléments utilisés pour créer cette expérience.
es_379J5II41QTXL65M4G1P992EU64LES	1. tout d'abord, j'aurais besoin de savoir quelle quantité de vinaigre ils ont utilisée pour chaque échantillon, et si elle est la même pour les différents matériaux.   2. j'aimerais également savoir quel instrument vous avez utilisé pour mesurer la masse.   3) Enfin, j'aimerais savoir de quel matériau sont faits les récipients dans lesquels vous avez stocké les échantillons avec le vinaigre (verre, aluminium, plastique, etc.).
es_37FMASSAYE4XO2LW9M2MGL4110FBI3	Pour pouvoir reproduire l'expérience, nous devons savoir quel type de plastique a été utilisé, car il en existe différents types, comme le PVC, le LDPE (que l'on trouve dans les sacs en plastique), etc. Les différents types de plastiques réagissent différemment au vinaigre. La température à laquelle le matériau est séché doit être la même. Il faut déterminer s'il sera à l'air libre, dans une pièce à température contrôlée ou dans une glacière. Je ne recommanderais pas l'air libre car il s'agirait d'une variable hors du contrôle du groupe. Vous devez également déterminer combien de temps les échantillons resteront sous l'eau distillée. En bref, vous devez énoncer des variables plus contrôlées telles que la température, le type de matériaux et la durée pendant laquelle ils seront sous l'eau distillée.
es_37Q970SNZGLL5I60C13BEBXFSY9S14	Tout d'abord, indiquez les dimensions (mesures) des échantillons. \N- Deuxièmement, indiquez la capacité des récipients dans lesquels les échantillons seront immergés. \N- Troisièmement, indiquez la quantité de vinaigre à utiliser (s'il faut recouvrir complètement les échantillons de vinaigre).
es_37Q970SNZGLL5I60C13BEBXFY431SP	1. quel type de vinaigre doit être utilisé.n2. Quel type de plastique utiliser.n3. Mesures de l'échantillon, des surfaces, pour être sûr que la surface sur laquelle le vinaigre fait effet est la même.
es_37TRT2X24S4TJD52R4NMSMJ1HJZJBT	On constate que le bois est celui qui a perdu le moins de masse, bien qu'il soit poreux par nature, par rapport au matériau calcaire, qui aurait pu se désagréger avec les solvants, ce qui expliquerait la diminution de sa masse. La perte de masse du plastique était négligeable, peut-être en raison d'une erreur de mesure, ou parce que le matériau s'était détérioré, une partie étant perdue dans les solvants.
es_37TRT2X24S4TJD52R4NMSMJ1OFJJBC	Densité
es_37UQDCYH6Z8F8W26VCPPQ88ZRBHV7U	On pourrait reproduire cette expérience en mesurant le poids de sept éléments différents à l'aide d'une balance scientifique. En utilisant sept béchers, il est possible d'ajouter à l'intérieur des matériaux tels que du tissu, du caoutchouc, du carton, du verre, de l'aluminium, de la pierre et de la céramique. Étiqueter, ajouter du vinaigre et sceller. Laissez tremper pendant _42 heures. Après 42 heures, utilisez de l'eau distillée pour rincer les matériaux, puis laissez-les sécher complètement. Avec une balance scientifique, mesurez à nouveau le poids des matériaux et ajoutez les données dans un tableau. Calculez la différence entre les masses (g).
es_37WLF8U1WR3IOLUPDY6QILXMJG66KV	CAliza
es_37XITHEISYMTR6GLD9SQ5XBA9JERCH	Quelle quantité de vinaigre mettre dans chaque récipient. _2. Quelle quantité d'eau distillée utiliser. 3. Assurez-vous que l'échantillon est bien l'échantillon déterminé.
es_37XITHEISYMTR6GLD9SQ5XBABRACRG	Quelle quantité de vinaigre faut-il mettre dans le récipient ?
es_382M9COHEJS04WSGDUTQ0WYXZVRUED	J'ai fait les procédures et elles ont été efficaces pour une chose : j'ai pu faire de l'eau distillée mais j'ai aussi pu faire de l'eau acide, une eau qui peut être utilisée comme liquide de refroidissement pour les insectes et pour l'acide des batteries.
es_38BQUHLA9YD33F0WY650EYBHR3PMOX	1. masse moyenne. 2. rayon de l'arc (m). 3. Hauteur de libération (m)
es_38F71OA9GV99X2N3Z3MAR4232Q9MF1	Quantité de vinaigre, taille de l'échantillon, quantité d'eau distillée
es_38YMOXR4MWC9JLO62CPT6WRH2A0W68	Pour reproduire l'expérience, j'aurais besoin de savoir quelle quantité de vinaigre a été utilisée dans chaque récipient, quelle quantité d'eau distillée a été utilisée, quel instrument a été utilisé pour déterminer la masse des échantillons et quelle méthode a été utilisée pour sécher les échantillons.
es_38YMOXR4MWC9JLO62CPT6WRH2HO6WK	Quel type de récipient a été utilisé pour verser le vinaigre, lorsque le matériau a été laissé dans le récipient de vinaigre, il a été laissé dans un endroit sombre, sous la lumière naturelle ou une lampe. Quel type de bois a été utilisé pour l'expérience.
es_38YMOXR4MWC9JLO62CPT6WRH7KWW6T	Après _24 heures, retirez les échantillons des récipients et rincez chaque échantillon avec de l'eau distillée.
es_38YMOXR4MWC9JLO62CPT6WRHDXQ6WT	VÉRIFIEZ LA QUANTITÉ DU MÉLANGE, COMMENT IL SÈCHE ET COMMENT ON OBSERVE LA MASSE.
es_392CY0QWG34D330NU7SZ87YVRBW4IU	TempératureHumiditéMatériau des récipients
es_39GAF6DQWTD1XAN46W8GPYHMQRO1VG	Tout d'abord, le type et la taille du récipient, qu'il s'agisse de verre, de plastique ou d'un autre matériau. Deuxièmement, la quantité ou les litres de vinaigre à mettre dans chaque récipient. Troisièmement, l'endroit où on le laisse reposer, s'il est au soleil ou à l'ombre, si ce facteur n'influence pas l'évaporation du vinaigre dans le cas où il est au soleil.
es_39GAF6DQWTD1XAN46W8GPYHMSPI1V8	Le volume des échantillons, car _10 grammes de marbre auront un volume plus petit que 10 grammes de bois. Le type ou le pH du vinaigre, le processus de rinçage (immersion ou non ?), la température de l'environnement dans lequel les échantillons sont laissés au repos.
es_39GXDJN2OVRJ8A7P5HHV484U9QA8VE	pour pouvoir faire un calcul plus précis, il faudrait savoir si le bois est complètement sec, il faudrait déterminer la composition du calcaire en pourcentages d'argile, de sidérite, d'hématite qui modifieraient le degré de cohérence de la roche. Il faut également tenir compte de la résistance du plastique, car selon sa composition, il peut être plus résistant que d'autres.  La masse initiale doit être égale.
es_39JEC7537WELKDX2MTX06U0DTYXVC1	Des informations supplémentaires seraient nécessaires sur la quantité d'huile qui doit être incluse dans chacun des conteneurs, la densité de l'huile et le volume des échantillons.
es_39LNWE0K4W9CK1U29DJHLBWPRK4IU8	Au minimum, vous devrez connaître le volume de chaque récipient, la quantité de vinaigre à ajouter et savoir si cette quantité est constante pour chacun des matériaux ou si elle est une proportion de la masse.
es_39LNWE0K4W9CK1U29DJHLBWPU9FIU0	1- Pourquoi faut-il laver les échantillons après les avoir sortis du récipient, cela pourrait affecter les résultats ? \N- Le volume et le diamètre de chaque masse doivent être identiques ou non \N- Quel type de vinaigre est utilisé pour l'expérience ?
es_39OWYR0EPM49RJCHI6ALLZPA6KUFYQ	le vinaigre a un effet sur certains des matériaux présentés ci-dessus en ce qui concerne la masse, pour d'autres les propriétés des matériaux restent presque les mêmes, la couleur de certains d'entre eux devrait changer, ainsi que leur odeur et leur forme, le calcaire devrait changer quelque peu.
es_39PAAFCODOD26UZD8FSQV40HFFOTVX	Pour améliorer les opérations ci-dessus, saisissez _1) la quantité de vinaigre versée dans les différents récipients. 2) le type de vinaigre utilisé. En outre, je calculerai également 3) le volume des masses.
es_39RP059MEJ6JKLBNU10E8EBIIGZBMX	Informations supplémentaires:_1. Instrument pour le rinçage de chaque pâte. Récipient dans lequel placer les pâtes. Dispositif de mesure de la pâte.
es_39U1BHVTDN4IULXUO5MKC98YPBCT3E	La quantité de vinaigre (par rapport à la masse de l'objet), la taille du récipient (par rapport à la masse de l'objet), le matériau du récipient.
es_39ZSFO5CAA98FCE8RV4HXCBP3AFJUS	Vous aurez besoin de la quantité de vinaigre, de la taille des récipients et de la taille des échantillons.
es_3A1COHJ8NL8EQ9C50S0RP7DL2NHH84	Vous devez connaître la quantité de vinaigre dans chaque récipient. Vous devez connaître la taille de chaque conteneur. Il faudrait connaître la taille des échantillons.
es_3A1PQ49WVJUWF9SK17RCAXQDICF1HS	le type de vinaigre, la quantité de vinaigre utilisée, la quantité d'eau distillée utilisée.
es_3A1PQ49WVJUWF9SK17RCAXQDJ1H1H9	l'acide acétique du vinaigre a rendu les masses plus légères mais n'a pas affecté le bois.
es_3A1PQ49WVJUWF9SK17RCAXQDJBSH1K	1) précisez la quantité de vinaigre à mettre dans chaque récipient (de préférence en ml).  2) préciser la quantité d'eau distillée avec laquelle chaque échantillon est rincé. 3) Comment se déroule le processus de rinçage ? 4) La taille et la forme des conteneurs ?
es_3AAPLD8UCEUXOT4T3QBMG398BHMHT6	Indiquez le mélange de vinaigre, le temps d'attente et le temps de repos, et indiquez le rinçage à l'eau.
es_3ATTHHXXWC1415OXEIU45IVTL9AXII	Quantité de vinaigre, température ambiante et concentration de l'eau.
es_3ATTHHXXWC1415OXEIU45IVTQZLIXZ	Je dois savoir quel type de vinaigre a été utilisé et quel type de bois a été utilisé, car selon le type de bois, il peut absorber plus ou moins de liquide. Quelle quantité de vinaigre dois-je mettre dans le récipient ?
es_3AZHRG4CU6XHEC03Q3YASY6T2BM30F	Je ne vois pas de questions
es_3B1NLC6UG19LW5GB23KKQTWA5SLGPO	Pour reproduire l'expérience, j'aurais besoin de savoir quel type de vinaigre a été utilisé, quelle quantité de vinaigre a été déposée dans chacun des récipients, et quel type de bois et de plastique a été utilisé, car il en existe plusieurs types et leurs propriétés varient.
es_3B2X28YI3YSHVIQV7LTXJIEWSB36BR	"J'aurais besoin de connaître le type de conteneur utilisé et sa taille. J'aurais besoin de savoir si les récipients dans lesquels les échantillons sont conservés pendant _24 heures sont fermés avec un couvercle ou non. Enfin, j'aurais également besoin de savoir à quels deux moments les quantités ""Masse initiale"" et ""Masse finale"" indiquées dans le tableau sont mesurées et quel instrument de mesure est utilisé."
es_3B3WTRP3DDFAPOSXMZ3Y2Z2UO4V29P	1) Pesez chacun des quatre échantillons avant de verser le vinaigre pour obtenir la masse initiale. Pesez chacun des quatre échantillons après les avoir laissés sécher, pour obtenir la masse finale. Soustrayez la masse finale de la masse finale pour obtenir le changement de masse de chaque échantillon.
es_3BDCF01OGZ7VRBMD4HDJGCUUEK0LY4	Pour reproduire l'expérience, il faudrait des échantillons de marbre, de calcaire, de bois et de plastique ayant le même poids initial que lors de la première expérience. Placez du vinaigre dans quatre récipients dans lesquels seront placés chacun des échantillons.  Après _24 heures, retirez les échantillons et rincez chacun d'eux avec de l'eau distillée. Laissez les échantillons reposer pendant 30 minutes, puis déterminez la masse de chaque échantillon.
es_3BF51CHDTXNW8K725ONCWS73C6L0H7	quelle est la température des échantillons ? quel est le niveau de condensation requis pour chaque élément ? quelle est la formule pour déterminer la masse ?
es_3BV8HQ2ZZYECC8L317T1O7UQK5SA68	comment déterminer la masse de chaque matériau (quelle sorte de bois ? quelle sorte de plastique ? ...)
es_3BWI6RSP7IMY6LGK0M0FQ4KDVDEE75	La masse ou le volume de vinaigre versé dans les récipients, la différence entre la masse du récipient avec le vinaigre avant de placer l'échantillon et après avoir placé l'échantillon et les matériaux utilisés pour l'étude.
es_3BXQMRHWK1BYGKKTUSH9D4367UAMUF	1) A quelle température ambiante l'expérience a-t-elle été réalisée. 2) Température et conditions de séchage. 3) Quantité de vinaigre utilisée en ml. 4) Quantité d'eau distillée utilisée pour le rinçage ?
es_3BXQMRHWK1BYGKKTUSH9D4367VHMUO	Il serait intéressant de faire cette expérience non seulement avec du vinaigre, mais aussi avec d'autres substances comme le lait, l'eau, l'huile. Nous pourrions alors déterminer comment chacun des échantillons ci-dessus réagit en fonction de la substance à laquelle il est exposé. D'après ce que nous pouvons conclure de cette expérience, le bois n'est pas altéré en masse du moins lorsqu'il est exposé au vinaigre, et le calcaire est le plus altéré par le vinaigre. Salutations.
es_3BXQMRHWK1BYGKKTUSH9D436GLHMUD	comment déterminez-vous la masse au début (par quelle méthode), comment déterminez-vous la masse des échantillons à la fin, quelles sont la taille et la composition des récipients ?
es_3C2NJ6JBKCUVEQWRN9M3K0XEYZG2N9	Pour commencer, pour reproduire cette expérience, il suffirait de changer les éléments pour effectuer des tests différents et obtenir des résultats montrant des changements significatifs dans leur masse. Dans un premier temps, nous pourrions utiliser des éléments tels que le carton, le plastique, le verre et la brique pour prélever des échantillons que nous pourrions mettre dans des tubes à essai (ils sont bon marché) auxquels nous ajouterions du vinaigre afin de ne pas modifier le liquide avec lequel l'expérience est réalisée ou mettre d'autres liquides tels que du soda, des liquides de nettoyage (clorox-blanchiment) et de l'eau de pluie pour connaître les différents effets de ces liquides sur chaque matériau. Il est également important d'avoir les éléments pour la mesure des échantillons qui vont être utilisés et ainsi avoir les données initiales et les données finales. Il serait souhaitable de réaliser cette expérience dans un endroit où personne ne peut la déplacer et où la température ne varie pas beaucoup afin que les échantillons soient toujours stables et qu'il n'y ait pas d'effet majeur sur eux lors de l'examen des résultats. Cette procédure, comme on peut l'apprécier dans l'expérience précédente, doit être construite et laissée pendant _24 heures pour que le liquide ait un effet sur le matériau à tester. J'ajouterais des données comme : Résistance du matériau.
es_3C44YUNSI32IKL6K0DJCK8TD1LOPDL	Informations supplémentaires nécessaires_1. Type de bois - il existe plusieurs types de bois de densité différente2. Degré d'acidité du vinaigre - important3. Quantité de vinaigre dans chaque récipient4. Les conteneurs sont couverts pendant 24 heures ou laissés ouverts.
es_3CFVK00FWNYT8RC7YYIRXLA1E006LX	MARBRE
es_3COPXFW7XDPQYRCUSU5ZOLO3JWQPK5	Taille du récipient, quantité de vinaigre et conditions environnementales (par exemple, lumière et température).
es_3CTOC39K3936H12CENB6NKX5XN6J7S	Il est nécessaire de préciser la quantité de vinaigre, la taille du récipient et la quantité d'eau distillée utilisée.
es_3D3VGR7TA2S5E6K2KGHPCU7G1D83RE	- De quel matériau les récipients doivent-ils être faits, les récipients doivent-ils être couverts pendant la période de _24 heures, quelle quantité de vinaigre doit-on verser dans chaque récipient, les échantillons doivent-ils être complètement couverts de vinaigre et quelle quantité de vinaigre doit-on verser dans chaque récipient ?
es_3D4CH1LGEC604I04LEON43WV7UD9GF	"Pluies acidesLes pluies acides sont une forme de pollution acide, désignant la chute (dépôt) d'acides présents dans l'atmosphère par la pluie, le brouillard et la neige (également appelé dépôt humide). nLes principaux précurseurs des acides sont les oxydes de soufre (SOx) et les oxydes d'azote (NOx), qui sont émis par les centrales électriques, les moteurs à combustion interne des voitures et des avions et certaines autres industries, en tant que produit de la combustion de combustibles contenant de faibles pourcentages de soufre (S) et d'azote (N), tels que le charbon, le gaz naturel, le gazole, le pétrole, etc. nLes acides, principalement l'acide sulfurique et l'acide nitrique, se dissolvent dans les gouttelettes d'eau qui forment les nuages et dans les gouttes de pluie elles-mêmes, se déposant sur le sol. Ces deux acides trouvent leur origine dans l'atmosphère lorsque le trioxyde de soufre (SO_3) et le dioxyde d'azote (NO2) réagissent avec l'eau, l'oxygène et les autres produits chimiques présents. En présence de la lumière du soleil, la vitesse de la plupart de ces réactions augmente.n Il existe également une autre forme de pollution acide appelée ""dépôt sec"", qui désigne les gaz et les particules acides qui sont transportés par le vent et frappent les bâtiments, les voitures, les maisons et les arbres. Les fortes pluies constituent une autre voie de lessivage. Dans ce cas, des substances acides sont incorporées dans les pluies acides, ce qui contribue à en augmenter l'acidité.n Environ la moitié des substances acides présentes dans l'atmosphère retombent au sol par le biais des processus de dépôt sec.n Comment mesure-t-on les pluies acides?nLes pluies acides sont mesurées sur l'échelle du ""pH"", le potentiel hydrogène. Plus le pH d'une substance est faible, plus elle est acide.nL'eau pure a un pH de 7,0 et la pluie a normalement un pH compris entre 5 et 6, c'est-à-dire qu'elle est légèrement acide, transportant de l'acide carbonique qui se forme lorsque le dioxyde de carbone de l'air se dissout dans l'eau qui tombe. En revanche, dans les régions où l'atmosphère est polluée par ces substances acidifiantes, la pluie a un pH pouvant atteindre 4 ou 3, et dans certaines régions où le brouillard est acide, le pH peut atteindre 2 ou 3, comme celui du jus de citron ou du vinaigre.n Quels sont les effets des pluies acides ? nLes effets causés par les eaux acides dépendent de plusieurs facteurs, tels que le degré d'acidité de l'eau, la composition chimique du sol et son pouvoir tampon, ainsi que les caractéristiques des organismes vivants affectés.nLes dépôts acides contribuent à l'abaissement du pH dans les écosystèmes terrestres et aquatiques et permettent la mobilisation de métaux toxiques, notamment l'aluminium. Cela entraîne une série d'effets, notamment des dommages aux forêts et aux sols, aux poissons et autres êtres vivants, aux matériaux de construction et à la santé humaine. Les pluies acides agissent également en réduisant la visibilité.n Dans les forêts, les pluies acides causent des dommages en décomposant les nutriments du sol, ce qui entrave la croissance naturelle des arbres. Les dommages peuvent s'étendre aux pâturages, nuisant au bétail, et aux lacs, tuant potentiellement un grand nombre de poissons.n Les effets des pluies acides sur le sol peuvent être accrus dans les forêts des zones de haute montagne, où le brouillard apporte des quantités importantes de polluants acides.n Les pluies acides contribuent à la dégradation des matériaux de construction et d'art (maladie de la pierre) et à la corrosion des métaux. Les monuments et les bâtiments sont sensibles à l'action des pluies acides. De nombreuses ruines ont disparu ou sont sur le point de disparaître à cause de ce facteur.nLes dommages causés aux personnes sont principalement indirects, par la consommation de poissons et d'eau potable contaminés par les pluies acides.nComment peut-on réduire les pluies acides ? nPour réduire les pluies acides, il est nécessaire de réduire l'émission des composés chimiques qui donnent naissance aux acides, c'est-à-dire les précurseurs d'acide, qui sont principalement le dioxyde de soufre (SO2) et les oxydes d'azote (monoxyde d'azote, NO, et dioxyde d'azote, NO2). nDe nos jours, la formation de SO2 peut être réduite en éliminant le soufre des combustibles fossiles ou en piégeant les SOx avant qu'ils ne soient émis dans l'atmosphère, grâce à des réactions chimiques qui les transforment en espèces chimiques moins réactives. L'utilisation de convertisseurs catalytiques réduit la formation de NO et NO2 en réduisant ces oxydes en N2 et O2."
es_3D8YOU6S9GXWRHZ17CASO86KHWA6U8	Vous devez connaître le type de composé du matériel expérimental pour savoir à l'avance la réaction que vous allez avoir (par exemple, s'il s'agit d'une base, d'un acide, etc. pour savoir s'il s'agit d'une réaction de neutralisation acide-base). \J'aurais besoin de connaître la quantité de vinaigre pour être sûr que la réaction aura lieu pendant les _24 heures et que le solvant (dans ce cas le vinaigre) ne s'épuisera pas par rapport au soluté (matière).
es_3D8YOU6S9GXWRHZ17CASO86KIXA6UB	Quelle quantité de vinaigre sera versée dans les récipients ? \N- A quelle fréquence les échantillons doivent-ils être rincés à l'eau ? \L'état des échantillons ; sont-ils liquides, solides ?
es_3DBQWDE4Y8BNDNFE5SO1I70QG345NW	L'information qui n'est pas incluse est le temps pour chaque échantillon, _24 heures, la même chose pour les 30 minutes, et enfin la différence.
es_3DBQWDE4Y8BNDNFE5SO1I70QLDT5NA	Densité initiale (Densité initiale)nDensité finale (Densité finale)nVolume initial (Volume initial)nVolume final (Volume final)
es_3DEL4X4EL8YQR532I0G7R6PHCWZXYO	la température, le volume du vinaigre et le matériau du récipient
es_3DH6GAKTY02FW03HJI4SOR5SIPKYZT	Afin de reproduire cette expérience, je dois connaître le volume de chaque matériau, la température initiale et finale de chacun d'entre eux et, enfin, j'essaierais d'ajouter un autre échantillon de matériau, comme le verre.
es_3DHE4R9OCYOP4YF50598UGOH2F1G2B	J'ai besoin de connaître la température à laquelle les échantillons ont été conservés, la taille des échantillons et le volume de vinaigre utilisé.
es_3DL65MZB8FS4I2BGR38Q6QCRRTECEA	J'aurais besoin de la taille de chacun des échantillons, tous les matériaux ne sont pas les mêmes, même s'ils ont un poids similaire.  J'aurais également besoin de connaître l'heure à laquelle les échantillons ont été placés dans le vinaigre. Je pense que, qu'il fasse jour ou nuit, il y aurait une différence entre les mesures car elles peuvent être affectées par la température. Vous devez également connaître la saison à laquelle l'expérience a été réalisée, car la différence de température peut apporter un changement majeur au cours de l'expérience.
es_3DQQ64TANIYHTR6BH8O2CWIY193WPJ	la quantité de vinaigre à mettre dans les récipients la taille des récipients et l'endroit où laisser reposer les échantillons.
es_3DY4FPOOA31PQFML4QNVVPZZUFPVRT	La quantité de vinaigre à mettre dans chaque récipient.
es_3DY4FPOOA31PQFML4QNVVPZZWQIRV6	J'aurais besoin de savoir si les échantillons doivent être immergés dans le vinaigre, ou la quantité de vinaigre utilisée. Une meilleure description des objets serait utile, car la surface des objets peut affecter les résultats.
es_3DZQRBDBSNSHFLKFZ5HU24CCXAW3S7	Type et matériau du récipient ; balance ; quantité de vinaigre.
es_3E337GFOLBLLTK4YMO7SM4RFEJANGA	Quantité de vinaigre utilisée dans chaque échantillon, n_2. Températures, n3. Poids supplémentaires : (a) des récipients, (b) des matériaux avant le rinçage à l'eau distillée et le repos.
es_3E47SOBEYS9GY7D2NMYHR5AJMCOCI5	Bonjour, en tenant compte du fait que le vinaigre est une composition chimique d'acides acides qui peuvent provoquer des réactions entre les matériaux exposés à l'expérience. _1) du vinaigre sur du marbre. comme nous le savons tous, le marbre est la composition de roches calcaires, et comme nous savons tous ce qui se passe lorsque nous prenons une roche et que nous y ajoutons de l'eau, elle se désintègre. la même chose se produit avec le marbre, bien que nous devions tenir compte de l'acidité du vinaigre. et la dureté du marbre, c'est pourquoi la perte de masse n'a pas été plus importante, 2) en ce qui concerne les roches calcaires, comme je l'ai déjà mentionné, une rose est plus sujette à l'usure, c'est pourquoi on constate dans les échantillons que la perte est plus importante que celle du marbre. 3) dans le cas du bois, il absorbe du vinaigre, comme vous le savez, et sa masse augmente, mais lorsqu'il est laissé au repos, il revient à sa masse initiale en séchant, de sorte qu'il n'y a pas de différence entre la masse initiale et la masse finale. 4) la pratique mondiale utilisée comme stockage de toute matière à l'état liquide a aussi subi une petite et insignifiante usure produit du temps qui a agi sur l'acide du vinaigre à l'intérieur du récipient. J'espère que mon opinion vous a plu et que vous l'évaluez positivement.
es_3E47SOBEYS9GY7D2NMYHR5AJNK9CI7	1. quelle quantité de vinaigre doit-on utiliser ? 2. quelle quantité de vinaigre doit-on utiliser ? La taille des conteneurs. La concentration d'eau distillée à utiliser.
es_3EF8EXOTT38S6FNAP7UXMA6SWM11JG	J'avais besoin de savoir : la température de l'eau distillée - la température ambiante pendant les _24 heures - si les récipients étaient fermés ou ouverts.
es_3EJJQNKU9TIK8ER1Z16RGO8QJDIHRG	Nous devrons expliquer quels sont les résultats et quels sont les ingrédients dont nous avons besoin.
es_3EJJQNKU9TIK8ER1Z16RGO8QRMBHRZ	En notant que chaque matériau a été placé dans la cuve, la masse a eu une différence de réaction, mais parmi les différents types, le bois s'est démarqué car il n'y a pas eu d'altération de la masse et il a réussi à avoir sa grande différence.
es_3EJPLAJKEOTDDGTBDZ9050LZSKDZ6Z	J'aurais besoin de connaître la taille du récipient, son matériau et si le vinaigre recouvre complètement l'échantillon (c'est-à-dire s'il est immergé ou non).
es_3EO896NRAY8TFZZJRQE7SGPNTDPTJZ	calcaire
es_3ERMJ6L4D05WI98XHKOY3CPM2PLM70	Vous pouvez répéter l'expérience en utilisant les mêmes matériaux mais à des températures différentes (par exemple dans un réfrigérateur, au soleil, etc.). Vous pouvez répéter l'expérience avec les mêmes matériaux mais avec des acides différents (par exemple des acides citriques, de l'eau gazeuse, etc.). Vous pouvez également répéter l'expérience en gardant le même acide mais en utilisant des matériaux différents (par exemple du fer, des os, de la viande - pour introduire des matériaux biologiques au lieu de matériaux physiques, etc.)
es_3ERMJ6L4D05WI98XHKOY3CPMA8L7MV	Quelle quantité de vinaigre est nécessaire ?
es_3EWIJTFFVQKKOAG0FNF6BPAQMQ2E0G	Je ne sais pas.
es_3F0BG9B9MR0WCQXB0NC9X7CT8V77Y8	Je dois connaître la température des matériaux, la quantité d'eau distillée utilisée et son degré de pureté, ainsi que la quantité de vinaigre utilisée.
es_3F6HPJW4JFDL1K55FADQGJA5PYZ2WN	1. combien de vinaigre faut-il pour chaque échantillon ? 2. Matériau sur lequel les échantillons sont séchés 3. Quel doit être le poids de chaque échantillon ?
es_3FE2ERCCZZL9OIX9QMXSV25CUHMPOY	1- Quantité de vinaigre (peut affecter la réaction chimique). 2 - Température (peut affecter le temps de séchage). 3 - Sensibilité de l'instrument utilisé pour mesurer la masse (peut affecter le résultat final de l'expérience). 4 - Type de récipient dans lequel les échantillons ont été conservés pendant 24 heures (l'air, la lumière, etc. peuvent affecter la réaction chimique).
es_3FE2ERCCZZL9OIX9QMXSV25CYCKOPP	la quantité de vinaigre ajoutée à chaque échantillon, la pesée des récipients, la température à laquelle les échantillons ont été laissés.
es_3FE7TXL1LK0GHN9J31EKOUSJYAP2QD	De quoi sont faits les échantillons, quelle quantité de vinaigre ajouter, comment peser les échantillons.
es_3FE7TXL1LK0GHN9J31EKOUSJZFD2QC	Je pense que les tableaux pourraient être un peu améliorés avec une image de meilleure qualité pour les lecteurs.
es_3FIJLY1B6WHFI5KGRJE288WY5EGPFW	- La quantité de vinaigre dans chaque récipient. Il indique que les récipients sont identiques mais pas la quantité de vinaigre dans chacun d'eux. Différence dans les résultats si les échantillons ne sont pas rincés à l'eau distillée. Cela fait une différence si les échantillons sont sur une surface absorbante.
es_3FTF2T8WLTVW14Q40JS5Q6IJTY39W2	Les informations supplémentaires requises seraient la quantité de vinaigre ajoutée aux échantillons et un groupe témoin.
es_3FTYUGLFSWYERBO1GYAYM2OW08JD5J	J'aurais besoin de connaître les données supplémentaires suivantes : - Quel type de vinaigre a été utilisé (car il existe différents types de vinaigre, tels que le vinaigre de cidre de pomme, le vinaigre de xérès, etc.) - De quel matériau sont faits les récipients.
es_3G5W44VEU9VKLEJVPBFCUCABASGKGB	Quelle quantité de vinaigre ? Quels sont les échantillons ? Quel type de récipient ?
es_3G5W44VEU9VKLEJVPBFCUCABE9UKGR	SELON CE TABLEAU, LA VALEUR ÉLEVÉE DIFFÉRENTE DE LA MASSE FINALE EST LE PLASTIQUE. SA VALEUR EST DE _0 ET LA PLUS PETITE VALEUR DU CALCAIRE EST DE -0.01. LA CONCLUSION DE CE TABLEAU EST QUE LE PLASTIQUE EST TRÈS MAUVAIS POUR L'ENVIRONNEMENT DANS LE MONDE ENTIER. LE PLASTIQUE EST DONC UN TRÈS MAUVAIS MATÉRIAU.
es_3GDTJDAPVWO0INDGRPG4HCLHBN98MH	Pendant l'expérience dans les données, j'ai observé que le bois a beaucoup plus d'efficacité que les autres, y compris le marbre.
es_3GGAI1SQEXB2UQ3T81W9JYH07VOCMP	Quel est le matériel que nous mettons avec les échantillons et pourquoi nous utilisons ce matériel particulier ? Que fait le matériel aux échantillons ? \Pourquoi la masse de chaque échantillon change-t-elle ?
es_3GLB5JMZFZ8C78DLXUTPQZFLUMCGDX	Avec les données données, il est plus que suffisant de connaître la masse finale et de faire le calcul.
es_3GS6S824SSAHQ6UY1TBA87D33M1WN8	) J'ai besoin de savoir quelle quantité de vinaigre est ajoutée à chaque masse. \n_2.) Quelle taille ou quantité de pâte/matériel dois-je utiliser ? 3.) Combien de temps faut-il le laisser reposer après l'avoir rincé à l'eau distillée ?
es_3GU1KF0O4KEP5O80MHS6PI5DOOBPBF	Les récipients doivent-ils rester fermés ou ouverts pendant les _24 heures ? Les échantillons doivent-ils reposer et sécher à nouveau dans le récipient ou ailleurs ? Y a-t-il des conditions de température ambiante à prendre en compte ?
es_3HMIGG0U4NJ0C42UAS4FB78OKHV8YJ	De quel matériau sera fait le conteneur ? \Les masses doivent-elles être pesées ?
es_3HMVI3QICL5I14I9B7V0WXLGAZQY16	SELON CE TABLEAU LES RÉSULTATS DU FORUMUESTRA DEVRAIENT ÊTRE LE MARBRE, LE BOIS CALCAIRE ET LE PLASTIQUE DANS CE BOIS EST LE PLUS HAUT NIVEAU DE MASSES DIFFÉRENTES DE _0.00 ET LE PLUS BAS NIVEAU DE CALCAIRE EST -1.3 AM LE MARBRE EST -0.4 ET LE PLASTIQUE EST -0.01
es_3HRMW88U183I0Y8DWL3POXFZU9OM05	BOIS
es_3HUTX6F6VW0DWBW3OOMGZPXJK6T2OM	a) Quel est le but de l'expérience ? b) Utiliseriez-vous différentes solutions d'acide ? c) Plus d'échantillons de contrôle variant différents objets qui sont plus sensibles ou non à l'acide ?
es_3HWRJOOET7FKPJ0COPYQLVG9EXZSEM	volume initial de l'objet, volume final de l'objet, densité initiale de l'objet, densité finale de l'objet, différence entre les densités.
es_3HYA4D452TWJQYJAPL3QCVO5VVFF29	Quantité de vinaigre utilisée Indiquez si le vinaigre est commercial ou s'il s'agit d'acide acétique (si oui, indiquez sa concentration) Indiquez s'il est séché dans l'environnement ou dans une étuve.
es_3I7DHKZYGPDBPV2X745OA2RHEP45F1	Quantité de vinaigre à placer dans chaque récipient. _2. 2. le type de vinaigre. 3. le type de conteneur dans lequel chaque matériau doit être placé.
es_3IAEQB9FMGX84U3LCZX7C219OTOWD0	La taille de la pièce, le type de matériau et la quantité de vinaigre à y placer,
es_3IGI0VL649X9LXLWA7K0RD0HVWWNO0	J'aurais besoin du type ou de la marque de vinaigre, de l'objet utilisé pour chaque matériau, et du degré d'exposition à la lumière.
es_3IHR8NYAM9E5KPNR72IJH4Z7GT9P4K	Quelle est la quantité de vinaigre, de quel matériau sont faits les récipients, quelle est la quantité d'eau distillée, comment le matériau a-t-il été séché.
es_3ITXP059PYWS0ZM42Q9HIBT1IA2JSE	1) Quelle quantité de vinaigre dois-je ajouter à chaque expérience ? 2) Quelle quantité d'eau dois-je utiliser pour laver les échantillons, quelle que soit la quantité ? 3) Pendant que j'attends les 30 minutes de séchage, dois-je les laisser à quelle température ? à l'air libre ou à l'intérieur ?
es_3IX2EGZR7DWGZKMRN19CS1O53IFJRD	Quantité de vinaigre utilisée pour chaque échantillon. Le type exact de vinaigre, ou l'acidité du vinaigre. Les conditions extérieures (température, pression atmosphérique). La quantité de surface des échantillons, ou leur géométrie.
es_3IXEICO794WHR4KC77KIJCKIYJ46TK	La taille du récipient, le matériau dont il est fait et la quantité de vinaigre utilisée.
es_3J2UYBXQQNPGBVNL95W8Z1ID174603	J'aurais besoin de savoir quelle quantité de vinaigre ajouter à chaque échantillon, et aussi si la quantité de vinaigre doit être relative à la masse de l'échantillon au début de l'expérience. Vous devez également savoir quel est le but de l'expérience afin de pouvoir utiliser les résultats pour tirer des conclusions, des calculs sont susceptibles d'être effectués. La température peut également être importante dans les expériences, vous devez connaître la température à laquelle l'expérience originale a été menée afin de reproduire les résultats correctement.
es_3J88R45B2IBWIRB1RDKOEFW5D0NXP8	J'aurais besoin de connaître la quantité de vinaigre à ajouter au récipient dans la procédure _2. J'aurais besoin de savoir si le récipient doit être fermé ou laissé ouvert et enfin j'aurais besoin de savoir exactement quel type de matériel, quel type de plastique, quel type de bois pour reproduire l'expérience.
es_3JBT3HLQFAFLNMBGSV89B0CGEI5ZPK	J'aurais besoin de savoir quelle quantité de vinaigre a été mise dedans, si tous les matériaux ont été complètement recouverts par le vinaigre et comment les matériaux ont été séchés (à l'air libre ou avec un sèche-cheveux).
es_3JBT3HLQFAFLNMBGSV89B0CGLP3PZT	1. quelle était la taille des conteneurs.n2. Quelle quantité de vinaigre a été utilisée par récipient.n3. Si tous les échantillons ont la même surface.
es_3JCG6DTRV53X96B45C4LKCQMFIJQQ0	Type de moûts utilisés, concentration du vinaigre et son type.
es_3JCG6DTRV53X96B45C4LKCQMN95QQC	Afin de reproduire l'expérience, je dois d'abord connaître la quantité de vinaigre versée dans chaque récipient. Deuxièmement, j'ai besoin de connaître la taille et la forme des récipients qu'ils ont utilisés. J'aurais également besoin de connaître la quantité et la température de l'eau distillée utilisée pour rincer chaque échantillon. Je ne suis pas sûr que l'un ou l'autre des facteurs ci-dessus ait un effet sur les résultats.
es_3JNQLM5FT6Z5QQT6BW6O78TPPXGL28	Eau
es_3K3R2QNK8DGJ901Z5JD48IXM9ZAU95	Afin de reproduire l'expérience, j'aurais besoin de : _1. Connaître la température de la pièce car elle affecte les processus de réaction chimique. \n2º Connaître la masse de vinaigre qu'ils ont ajouté ou au moins savoir s'ils ont recouvert complètement les échantillons ou non (ce n'est pas clair)\n3º Les descriptions des échantillons sont vagues, un simple mot, pour pouvoir le reproduire j'aurais besoin de savoir de quel type de plastique il s'agit et de quel type de bois il s'agit. Quant au marbre et au calcaire, je pense qu'ils constituent un matériau unique et spécifique.
es_3KGTPGBS6ZY89GG0KAYPYVP83C62UT	Calcaire
es_3KJYX6QCMBO8SR38WLEMTYD8IIXJVT	On manque d'informations sur le volume du vinaigre pour analyser sa réaction avec les matériaux sélectionnés.
es_3KKG4CDWKKBKS27KQDMMVEZS9KK94Q	C'était une expérience unique de voir comment une masse est déterminée lorsqu'elle est dans le vinaigre.
es_3KOPY89HMAFOGI1PCB8GA3LPRSRJ37	Calcaire
es_3KV0LJBBH4Y60SSCQYM48TGM79JMRN	La liste des éléments nécessaires au début, y compris les endroits où ils peuvent être obtenus et les tailles. Quel est le but de l'expérience, ce qu'il faut faire avec les résultats, la signification des résultats et comment les appliquer à la vie ordinaire ou aux projets ou emplois.
es_3L2IS5HSFCV4Y25T6TW9QJS6JCYUNS	SELON CE TABLEAU QUATRE LISTE DE CADRES D'ÉTUDIANTS CI-DESSOUS EST A, B, C, D. L'HISTOIRE DU POINT DE CRÉDIT LE PLUS ÉLEVÉ DE L'ÉTUDIANT B ET L'HISTOIRE DU POINT DE CRÉDIT ET CHAQUE ÉTUDIANT A UN SCORE MOYEN DE C ET D. L'ÉTUDE CONTIENT UNE UTILISATION PLASTIQUE ET LA MAINTENANCE DU RÉSULTAT.
es_3L2IS5HSFCV4Y25T6TW9QJS6KCXUNS	La quantité de vinaigre dans chaque récipient serait nécessaire. Taille de l'échantillon. La quantité d'eau utilisée pour le rinçage, afin qu'elle soit la même pour chacun. Le poids utilisé pour trouver la masse. Enfin, où était-il mis à sécher ?
es_3L6L49WXW2A1RF58NN95JYUQMPJ45D	Vous devez connaître : la quantité de vinaigre utilisée le type de vinaigre utilisé le type de récipient utilisé le temps et la manière dont l'échantillon a été rincé.
es_3L6L49WXW2A1RF58NN95JYUQWOT54W	1) La quantité de vinaigre qu'ils versent dans chaque récipient.n2) Le type de vinaigre qu'ils versent.n3) La taille des récipients.
es_3L70J4KAZIZBXH0IBU1FUD4IX5ZDAB	CEUX-CI, COMPARÉS AUX PRODUITS, SONT PLUS GRANDS QUE LE BOIS.
es_3LKC68YZ3CGZ8RUA28BNNWD8OJOWOA	J'aurais besoin de pâte, de _4 récipients, de vinaigre et d'eau distillée pour pouvoir reproduire l'expérience.
es_3LKC68YZ3CGZ8RUA28BNNWD8OKEWO2	S'ils sont stockés à la lumière ou à l'obscurité. Température de l'environnement dans lequel ils sont stockés.
es_3LPW2N6LKVF08DZN2T0NW2SKMJMU54	Quel est le pH du vinaigre ? Quel type de balance a été utilisé ? Quelle quantité d'eau distillée a été utilisée ?
es_3LQ8PUHQFN57FFOI9ECI2W7Z3WJIHY	Après _24 heures c'est la même chose, laisser sécher, répéter chaque fois.
es_3LRLIPTPESMJBN6S3BN2YQZ8KDFKAF	La quantité de vinaigre utilisée, la quantité d'eau distillée utilisée pour le rinçage et la manière dont le processus de rinçage et de séchage a été effectué, la forme des échantillons de matériaux et la composition spécifique de chaque matériau.
es_3LRLIPTPESMJBN6S3BN2YQZ8L2CKAR	Pour reproduire l'expérience, j'aurais besoin de connaître les conditions du site où les échantillons ont été stockés, la quantité de vinaigre utilisée, le type de poids utilisé et les paramètres dans lesquels ces échantillons ont été choisis.
es_3LUY3GC631D23C5A90GQKGJHDNWP7R	Vous aurez besoin des mêmes éléments que ceux utilisés pour l'échantillon. Vous devez également savoir quelle quantité de vinaigre vous avez utilisée. Vous devrez également retirer les échantillons en même temps que vous avez effectué le premier test.
es_3LWJHTCVCEZ0IHLVRWTR8DM88TCQFY	Pour reproduire la procédure, vous aurez besoin de _4 autres récipients neufs et propres et de 4 autres échantillons identiques à ceux utilisés dans la procédure. J'aurais également besoin de savoir quelle quantité de vinaigre a été ajoutée aux échantillons lors de la première procédure afin de savoir quelle quantité ajouter. Peut-être qu'après la procédure initiale et la détermination des changements dans la masse de chaque échantillon, je continuerais à observer comment les échantillons changent en déterminant la masse trois fois de plus à des intervalles de 30 minutes.
es_3M0NZ3JDP3BHUCTX8GZVDU7ZVJRZ5V	marbre
es_3M1CVSFP62I5MQ4NGG7ZUCBHK9QAQX	Quelle quantité de vinaigre verser dans l'endroit où les échantillons sont stockés pendant _24 heures, température de l'air ouvert ou fermé. nTaille des récipients nMatériau dont est fait le récipient.
es_3M23Y66PO4KGC47XI7FS97OWYMM6S1	Quelle quantité de vinaigre ? Quelle est la température de la pièce pendant les _24 heures ? Quelle est l'humidité relative de la pièce pendant les 24 heures ?
es_3M68NM076JK4BP7K3IFNJXJ0HJX6RA	J'aurais besoin de connaître la température et l'humidité de l'air ambiant.
es_3MAOD8E57SNWF6ZOBY7WAQRAD13XNP	1. vous devez connaître le type de récipient recommandé car différents types de récipients peuvent faire varier les masses finales obtenues. 2. Il serait souhaitable de standardiser la masse des échantillons initiaux afin qu'il y ait une proportionnalité dans la différence entre les masses. 3. Il convient d'utiliser au moins trois décimales pour les mesures, car avec de si petites masses, des données peuvent être générées et rejetées en raison de problèmes d'arrondi. Il est conseillé de préciser le type de vinaigre à utiliser car les vinaigres naturels ou synthétiques peuvent donner des résultats différents.
es_3MRNMEIQW7JST0RM8LQ53RKTLW2DLL	"En principe, j'ai des doutes sur le bois. A-t-il été prétraité avec des produits chimiques ? Car sinon, il aurait dû absorber plus de liquide et donc augmenter sa masse, car c'est l'une des caractéristiques du bois. Je ne pense pas que _30 minutes aient été suffisantes pour que le bois fasse évaporer le liquide et j'aurais dû voir plus de différence. D'autre part, il aurait été plus intéressant de faire l'expérience en utilisant des échantillons ayant la même masse initiale. De cette façon, il est plus facile de comparer les résultats. Enfin, il est important de nettoyer les échantillons car l'utilisation du vinaigre a probablement ""nettoyé"" les échantillons des débris et c'est pourquoi il y a une différence après le séchage."
es_3MX2NQ3YCB7SPHTI7YBAG9ROFOP5X2	J'aimerais savoir quel type de vinaigre a été utilisé, quelle quantité a été utilisée dans chaque récipient et à quelle vitesse le vinaigre a agi dans chaque récipient.
es_3N1FSUEFL7DWVSK12TROHAII07G4DN	Précisez la quantité exacte de vinaigre nécessaire pour chaque échantillon Température à laquelle les échantillons doivent sécher Lieu et température du repos de _24 heures pour chaque échantillon
es_3N8OEVH1FT3R3IL8BMKD620MMDGOOA	type de vinaigre, concentration du vinaigre, quantité de vinaigre utilisée, température à différents moments, répéter l'expérience à différentes températures.
es_3NAPMVF0ZYS6B544725EO3BOTKV72I	Je ne serais pas en mesure de répondre.
es_3NC5L260MQZXX58FCJ1NJ8R8TBVFOI	Quantité de vinaigre à utiliser, type de vinaigre, concentration,
es_3NJM2BJS4YJ8FT060HO102BV93PPCR	DEterminez dans quelle mesure le récipient est rempli de vinaigre. Si l'échantillon peut être vérifié sans perturber le liquide, identifiez pourquoi certains objets ont perdu plus de masse que d'autres. En raison du matériau ?
es_3NKQQ8O390IVCQEGHZI6UEGCZJDDUQ	Bois
es_3NL0RFNU0H049YQBUADBLND8KAX4K8	Quel instrument utilisez-vous pour déterminer la masse ? De quel type de matériau les _4 récipients doivent-ils être faits ? Quelle quantité de vinaigre ajoutez-vous ? Quel poids est suggéré pour chaque échantillon ?
es_3NOKK93PR3LJF0VUNUELWECUES2EES	Vous allez avoir besoin de plus de plastique et de calcaire pour refaire l'expérience.
es_3NOKK93PR3LJF0VUNUELWECUM2QEE8	1. Quantité de vinaigre à ajouter 2. D'où proviennent les échantillons3. Type de conteneur utilisé4. Conditions dans lesquelles il a été conservé pendant les 24 heures, (température, pression)
es_3NPI0JQDAQIP1A2HM3JRPCBZTNVPT8	Pour reproduire l'expérience, il serait nécessaire de connaître la composition chimique ou la marque (exacte) du vinaigre utilisé, la quantité de vinaigre utilisée pour chaque échantillon et la composition de chacun des matériaux testés.
es_3NVC2EB65SCEB7WOYB9JKQ0DCXX3YS	La quantité de vinaigre qui a été mise dans chaque échantillon, le type de récipient où le vinaigre a été mis, et la taille des échantillons seraient nécessaires pour pouvoir reproduire cette procédure.
es_3O7L7BFSHG2VV5XGJD4CHTAM4Y5EIL	La quantité de vinaigre dont j'ai besoin. La quantité d'eau distillée. Quel type de conteneurs.
es_3O7L7BFSHG2VV5XGJD4CHTAM509EIU	Quel type de récipients utiliser, la quantité de vinaigre et la quantité d'eau distillée.
es_3OJSZ2ATDU9YA2NRPL7CMAE0FOY75L	Matériel de sécurité à utiliser, type de récipient, méthode de séchage idéale.
es_3OLQQLKKNU2RQGHM1VPCTUPMIL9EJT	Quel échantillon peut le mieux survivre dans une pluie acide. Dans ce cas, le calcaire présente une grande différence de -_1,3. Il ne peut donc pas survivre longtemps s'il reste dans un climat acide. Le marbre et le plastique se retrouvent également dans les pluies acides, mais ils fondent lentement. Le bois est le seul échantillon qui ne change pas et peut vivre dans un tel climat.
es_3OONKJ5DKEW7KOWZ7HFR0I0NJWTBOT	indice de réfraction du vinaigre température constante Gravité de la zone Humidité
es_3OS4RQUCRBSDEBJ68EW1DOR9LROBFF	Afin de reproduire la procédure, j'aurais besoin de savoir exactement quel type de vinaigre a été utilisé. Le type de lumière dans lequel ils se trouvaient, c'est-à-dire l'endroit où ils étaient situés, car la lumière et le climat peuvent affecter les résultats. La dernière chose que je voudrais également pouvoir reproduire est le type d'échantillon utilisé. Essentiellement, d'où proviennent les échantillons, en particulier le bois et le plastique, car il existe plusieurs types de bois et de plastique.
es_3OSWBBLG1GANTU8BM4TTELFGW5PDXO	La forme des échantillons (sont-ils en blocs, pulvérisés... ?), le type de plastique et de bois (il existe de multiples plastiques et le bois peut provenir de nombreux arbres différents), les échantillons sont-ils complètement immergés ou flottent-ils (au moins partiellement) ? et en relation avec cette dernière question : le volume et la forme du récipient.
es_3OVR4I9USRWQK1O67FX8H9PHI1HQ4J	J'aurais besoin d'obtenir les _4 échantillons et de connaître la quantité de vinaigre à verser dans chaque récipient.
es_3OWEPKL08BP20RTXTL3YGREM58QN7G	La quantité de vinaigre utilisée, le type de récipient utilisé, si les échantillons sont un seul morceau de matériau ou plusieurs morceaux qui s'additionnent pour atteindre le poids total de chaque échantillon. Si tous les échantillons sont dans leur état naturel.
es_3P529IW9K0YPRK5IZRLVRRNEX7ULFC	Nous aurions besoin de savoir quelle quantité de vinaigre a été versée dans chaque bécher, si les béchers contenaient le même vinaigre et quelles matières se décomposent plus facilement dans l'eau.
es_3P529IW9K0YPRK5IZRLVRRNEZHOFLM	Volume de vinaigre utilisé dans chaque échantillon. Taille minimale (volume) des récipients utilisés.
es_3PB5A5BD0XJWQZCB6HQ3Q75P3ZIG7K	Pour reproduire l'expérience, les choses les plus importantes à comprendre sont les quantités de matériel requises dans chaque expérience. Quelle quantité de vinaigre faut-il ajouter à chaque échantillon ? Il serait également préférable pour l'expérience que les mêmes quantités de chaque échantillon soient utilisées dans toutes les expériences. La température est importante dans les réactions chimiques et détermine souvent la vitesse de la réaction et son degré d'achèvement. Il est donc important de savoir à quelle température l'expérience originale a été réalisée. Il serait également important de savoir quel type de vinaigre utiliser - cela n'est pas spécifié dans l'expérience, mais pourrait avoir un effet important sur les résultats si on le change.
es_3PDJHANYK7TRMVTH7D3T5THUPX06HJ	Quelle quantité de vinaigre est nécessaire, quelle quantité d'eau est nécessaire, dans quelles conditions les échantillons seraient laissés à sécher.
es_3PDJHANYK7TRMVTH7D3T5THURMWH66	quelle quantité de vinaigre a été utilisée dans chaque récipient, combien de temps chaque échantillon doit être rincé à l'eau distillée, quel est le poids de chaque récipient sans l'échantillon.
es_3PH3VY7DJNAB7V8H4HM43UKC7E2ZW7	Une autre chose nécessaire pour reproduire l'expérience est de savoir quelle quantité de vinaigre a été utilisée. Plus précisément, combien de litres de vinaigre avez-vous utilisé pour chaque matériau, et si cela était cohérent. Une autre information nécessaire pour reproduire l'expérience est de connaître la masse initiale du matériau de départ, où les échantillons pour l'expérience ont été obtenus. Nous devons également savoir à quoi ressemblaient les conteneurs, de quoi ils étaient faits et où ils étaient stockés. Enfin, il est nécessaire de savoir s'ils avaient un contrôle pour chaque matériau, afin de s'assurer que la masse initiale n'est pas si différente de la masse finale sans l'utilisation du vinaigre.
es_3PM8NZGV80THI3CGRQZDEKMFIKZQXU	J'aurais besoin de savoir quelle quantité de vinaigre a été ajoutée à chaque échantillon. Il serait également utile de savoir à quelle température se trouvait la pièce où cette expérience a été menée, et combien de temps chaque échantillon a été rincé.
es_3PQ8K71NHZXDZAX6RKAD4CWCH4TAA6	J'ai besoin de connaître la taille de chaque échantillon, la quantité de vinaigre ajoutée aux échantillons, la taille des récipients et la quantité d'eau utilisée pour le rinçage. Avec ces détails, je pense pouvoir reproduire l'expérience.
es_3PQMUDRV7TJ7BAZ2FWU3288E62AIIS	Type de vinaigreMatériau du récipientConditions de stockage des récipients
es_3PS7W85Z81F49NMA5ENU3MBKQ3XT97	Quelle est la concentration ou le type de vinaigre utilisé ? Quelle est la capacité des récipients ? Quelle quantité de vinaigre a été versée dans les récipients ? Dans quelles conditions atmosphériques l'expérience a-t-elle été réalisée (température, humidité, pression atmosphérique) ?
es_3PS7W85Z81F49NMA5ENU3MBKWB2T9Y	Je ne comprends pas bien la question. _1) Pourriez-vous donner plus d'informations sur le type d'équipement nécessaire ? 2. le bois est naturel et ne change pas de masse. 3. la pierre calcaire s'est transformée en maçonnerie.
es_3PWWM24LHUBABJ9NH7XK237J4ZX82S	AVEC QUEL OUTIL MANIPULER LES ÉCHANTILLONS ? QUELLE QUANTITÉ DE VINAIGRE DOIS-JE UTILISER PAR RÉCIPIENT ? DOIS-JE FAIRE SÉCHER LES ÉCHANTILLONS AU SOLEIL OU À TEMPÉRATURE AMBIANTE PENDANT UNE NUIT OU DANS UN ENDROIT VENTILÉ ? QUELLE FORMULE PUIS-JE UTILISER POUR MESURER LA MASSE DE L'ÉCHANTILLON ?
es_3PWWM24LHUBABJ9NH7XK237JD8882U	Quantité de vinaigre, temps de trempage des échantillons dans le vinaigre, temps de séchage.
es_3PZDLQMM0VYCNMZ0YJDP4P32U7V2C3	Vous n'avez pas
es_3QECW5O0KJEL80KY2OADR66I2LZ5T3	vous devez connaître la quantité de vinaigre, la quantité d'eau distillée et la capacité des échantillons à absorber les liquides.
es_3QECW5O0KJEL80KY2OADR66I5SCT5L	Vous devez connaître les ingrédients mentionnés ci-dessus ainsi que les instructions.
es_3QECW5O0KJEL80KY2OADR66IAC3T5L	Altitude, température pendant _24 heures, température de séchage, température pendant 24 heures.
es_3QFUFYSY90STTCYXTZME5AL3BOZ4F8	Les élèves doivent indiquer le nom de chaque matériau, la taille de chaque matériau et la quantité de vinaigre à ajouter dans le récipient.
es_3QILPRALQ78605YG3QV4URAHO1D8NV	Masse initiale, masse finale et différence entre les masses
es_3QIYRE09Y5UOP5EV45MPFHN96KLN1E	Les informations supplémentaires qui pourraient être utilisées seraient la quantité de vinaigre ajoutée, la durée de rinçage des échantillons et le fait que les échantillons aient été complètement recouverts de vinaigre ou non.
es_3QRYMNZ7F0UPYPQ46O6ZLN643LSTNE	Je ne sais pas.
es_3QUO65DNQW1MGN5578WM58SB6HAOUV	Résultat final, photo avec la démonstration et les données
es_3QUO65DNQW1MGN5578WM58SBBZ2UOY	balance de précision, calculatrice, pince à épiler, pinces à épiler
es_3QUO65DNQW1MGN5578WM58SBD0OUOO	Il faudrait d'abord reproduire la procédure exacte avec le même matériau et la même quantité de vinaigre pour pouvoir vérifier les résultats obtenus.  Une fois répété, vous pouvez comparer les deux résultats et conclure par la différence moyenne entre les masses.
es_3QXNC7EIPK83TEPJ7CZKJB9FR7F099	Quelle quantité de vinaigre ajouter dans chaque récipient, quel instrument a été utilisé pour mesurer la masse, à quelle température se trouvaient les différents matériaux ?
es_3QXNC7EIPK83TEPJ7CZKJB9FR9T09R	Je pense que j'aurais besoin du délai dans lequel l'expérience sera menée. Les résultats peuvent être affectés selon qu'il fait nuit ou jour lorsque l'expérience est menée. J'aurais également besoin de la température de la pièce où la procédure a été menée. J'aurais besoin de connaître le type de chaque matériau, car chaque matériau a des versions différentes. Par exemple, le plastique, le gobelet en plastique et le récipient en plastique, sont tous deux en plastique mais ont des structures différentes.
es_3R9WASFE21T9W9MMESC4Z6YCCDJFZ0	Volume de vinaigre à mettre dans chaque récipient. Type de vinaigre à utiliser. Température à laquelle l'expérience doit être réalisée. Faites d'abord une liste des matériaux à utiliser dans l'expérience.
es_3RANCT1ZVHU2XTGW33R0ZOSCZSWBU3	La température de l'eau et de l'environnement, la fermeture ou non des récipients, le type de vinaigre utilisé et son pH.
es_3RRCEFRB7OP3GVMHOX0IMKUIWLZ4B8	De quel matériau sont faits les récipients ? Où laissons-nous sécher l'échantillon ? De quoi avons-nous besoin pour déterminer la masse ?
es_3RRCEFRB7OP3GVMHOX0IMKUIXNZB4K	quantité de vinaigre à utiliser, quantité d'eau distillée à utiliser, y a-t-il des dispositifs utilisés pour sécher les échantillons ?
es_3S06PH7KSTHF3TNIFB8MJCBFNUQ1D4	le niveau de vinaigre (si le matériau doit être entièrement recouvert), la température, le type de vinaigre, et pour moi le poids initial doit être le même.
es_3S06PH7KSTHF3TNIFB8MJCBFSLF1DG	Quel type de vinaigre faut-il utiliser ? Et quelle quantité d'eau distillée peut être utilisée. Dans quel endroit et à quelle température les échantillons sont conservés pendant _24 heures. Et où l'on laisse les échantillons reposer et sécher pendant 30 minutes.
es_3S96KQ6I9OHGCDZRHUSWPIUAJVSDT4	1) le temps doit être nécessaire. 2) l'espace de la formule 3) la masse moyenne.
es_3S96KQ6I9OHGCDZRHUSWPIUAKEETD9	1) Quel type de vinaigre utiliser : de l'acide acétique ou un autre composé ? 2) L'utilisation de l'acide acétique dans la fabrication du vinaigre. Quantité de vinaigre à utiliser dans chaque échantillon. 3. Type de lavage final, eau distillée uniquement ? un outil de récurage supplémentaire ?
es_3SB4CE2TJX8PVN5Z2U2ROK7ABHKAX5	"Dans la réaction, la paraffine de la bougie se combine avec l'oxygène pour donner du dioxyde de carbone et de l'eau (et quelque chose d'autre comme du carbone élémentaire ou ""char"" que nous pouvons oublier. Pour que la réaction fonctionne correctement, la paraffine doit apporter du carbone et de l'hydrogène dans les mêmes proportions que le méthane (voir figure). L'explication classique considère le côté gauche de cette réaction pour dire que l'oxygène disparaît au fur et à mesure que la réaction se produit, jusqu'à ce qu'il soit épuisé et qu'il ne reste que de l'azote (_4/5 de la quantité initiale, en raison de la composition de l'air)."
es_3SB5N7Y3O5HI8OCRLI5UBSV2XHY0GK	Certaines données peuvent être : la température, la quantité de vinaigre (ml) et l'état ou le type d'échantillon.
es_3SITXWYCNXMUEXAR882NJVRGPLDBXD	Il est conclu que : La masse de calcaire est plus encline à modifier sa masse, lorsqu'elle est altérée par le vinaigre, et la masse de bois est plus stable, ne subissant aucune modification lorsqu'elle est exposée au vinaigre. Je pense que cette expérience serait plus complète si, en plus du vinaigre, on utilisait un autre liquide comme le lait ou l'huile. Salutations.
es_3SLE99ER0PQJJSA69QQ8GG7R450BZA	JE VEUX PLUS D'INFORMATIONS SUR CE PALASTIC ET SES UTILISATIONS ET SON TRÈS MAUVAIS DE NOTRE MONDE ET SA RÉALISATION DE NOTRE MÉTHODE CHIMIQUE ET PLUS DE CALCAIRE.
es_3SNLUL3WO60EA228UGGUDROH830LUL	l'expérience est très bien élaborée et il n'y aurait pas besoin d'informations supplémentaires pour y répondre, une autre information supplémentaire me semble être au niveau de l'information.
es_3SUWZRL0M0QF2L2FHCVNKQKH5U16EU	la quantité de vinaigre pour chaque récipientrépétez un autre test pour valider les résultatsle temps de séchage devrait être plus long car certains matériaux comme le bois peuvent prendre plus de temps à sécher.
es_3TE3O85732LGTOOJGG3KTK2OY9NR2T	Comme les atomes sont invisibles dans une molécule, il doit y avoir un nombre entier et vous devez connaître la masse de l'échantillon en grammes.
es_3TEM0PF1Q7AFW420JS4M57S5S6K0DI	1- Précisez la matière des échantillons. n2- La mesure de la quantité de vinaigre à verser. n3- Comment retirer exactement les échantillons du vinaigre.
es_3TK8OJTYM3Y4E266RYJ6QUZKTKHPVL	Afin de pouvoir reproduire l'expérience, les éléments suivants doivent être connus : _1. La taille et le matériau du conteneur utilisé.2. Précisez la quantité de vinaigre à ajouter dans chaque récipient et indiquez si elle couvre entièrement l'échantillon.3. Détaillez le processus de séchage, à quelle température les échantillons sont-ils laissés à sécher.
es_3TR2532VIR7ND1O7VD6EH6X92U2J69	Plus de temps ?
es_3TVSS0C0E3DFLJZIYPXMH6JVOKDWTR	Je commencerais d'abord par inclure un contrôle d'un échantillon sans vinaigre pour voir si peut-être l'échantillon perd de la masse sans exposition au vinaigre. Ensuite, je réaliserais les expériences plus d'une fois, peut-être pas toujours la perte de masse exacte et troisièmement la quantité de vinaigre utilisée. N'utilisez pas non plus d'eau distillée, car l'eau peut affecter les échantillons.
es_3TXMY6UCAG1TF51L0U3Q0715E1EQCQ	Marbre, calcaire et plastique.
es_3U0SRXB7CFICIADC2Z14L85M6UBRNU	Il est nécessaire de savoir si les matériaux peuvent être uniquement inorganiques ou également organiques. Il est nécessaire de connaître les conditions de température et d'humidité pendant le temps de séchage.
es_3U5JL4WY5MMATYPITTS0BHLAGO94X4	quantité de vinaigre (ml), quantité d'eau distillée (ml), type de récipient
es_3U5JL4WY5MMATYPITTS0BHLAOHBX4T	Quel type de conteneur est utilisé ? Quel type de vinaigre est utilisé ? Où sont laissés les échantillons, à l'intérieur, à l'extérieur, au chaud, au froid ?
es_3U5NZHP4LTFZW1BMM922BT8BNY5HPA	1. le type de vinaigre 2. Quantité de vinaigre 3. La procédure de rinçage à l'eau distillée (temps, quantité, nombre de répétitions).
es_3U8YCDAGXRT9LD65OEA656Z4A02Q0Z	Quel effet le vinaigre a-t-il sur chaque échantillon ? Pourquoi le vinaigre a-t-il un tel effet sur la pierre ? Pourquoi le bois n'a-t-il aucun effet lorsqu'il est trempé dans le vinaigre ?
es_3UJ1CZ6IZJ2KT07JDO5NH1AWAJG5SH	Le type de vinaigre utilisé fait-il une différence ? nQuelle est la quantité de vinaigre utilisée dans chaque échantillon ? nLes récipients doivent-ils être en verre ? nIls doivent être couverts ou exposés lorsque les échantillons sont laissés au repos ?
es_3UJ1CZ6IZJ2KT07JDO5NH1AWBA0S57	Quel est l'aspect physique de l'échantillon?n_2. Ne pas laver les échantillons après 24 heures...yn3. Pesez immédiatement après 24 heures.  W = m/V
es_3UNH76FOCUIFXT4Y4TEYGP9J6TYMYF	Volume initial du vinaigre. Volume final du vinaigre. Temps de rinçage dans l'eau distillée ou volume d'eau distillée utilisé pour le rinçage. Volume initial de chaque échantillon (_11,2 g de bois peuvent occuper plus de volume que 9,8 g de marbre, et donc avoir moins de surface exposée au contact avec le vinaigre s'ils ne sont pas complètement immergés).
es_3UNH76FOCUIFXT4Y4TEYGP9J84BYMS	J'ai besoin des mêmes quatre échantillons différents et je dois savoir quelle quantité de vinaigre je dois verser dans chaque récipient.
es_3URFVVM167VYFRJC9H73L6ZFV69ZUF	"Ajoutez les informations suivantes pour améliorer les orientations et les informations : nn- Laissez les échantillons dans le même environnement pendant toute l'expérience, en évitant les endroits réfrigérés ou ensoleillés, ce qui permet d'éviter les fluctuations de température plus importantes et les interférences avec les résultats. nn- Créez un tableau avec les colonnes ""Nom de l'échantillon"", ""Masse initiale (g)"", ""Masse finale (g)"", ""Différence entre les masses (g)"" et pré-remplissez les lignes avec les informations recueillies."
es_3UXUOQ9OKGAVG8Z8KHYTULUM52A7A0	J'aurais besoin de connaître la quantité de vinaigre versée dans chaque récipient, le type de vinaigre et la vitesse à laquelle la masse de chaque récipient a diminué.
es_3VD82FOHKS1QUTO5LHBMB265VVWOC2	Temps, niveau de vinaigre, matériel
es_3VELCLL3GMWC1D1E6H3C7CE06FA1F6	Type de récipient, si les échantillons ont été testés en même temps et la forme des échantillons.
es_3VFJCI1K41C68IWQFVO9VOWPCBORGE	- Le poids initial - La quantité de vinaigre - Le type de récipient dans lequel les échantillons doivent rester.
es_3VHP9MDGRPXWOGBCMESWO8XR5WRCFW	Pour chaque procédure, le temps pris peut être observé et le résultat de chaque expérience consiste en des résultats différents, avec plus ou moins de cohérence.
es_3VNXK88KKEVJMFQZA9N944Z5WX2V95	Pour mieux expliquer l'expérience, nous devons d'abord peser la masse du vinaigre (donnée supplémentaire _1) et après l'expérience (donnée supplémentaire 2). Vérifier que la masse perdue par les différents échantillons s'est dissoute dans le vinaigre (masse acquise du vinaigre, donnée complémentaire 3).
es_3VSOLARPKDMZA6OGQZH3L97MUII39O	L'objectif de l'expérience n'est pas clair. Si je comprends bien, vous essayez de simuler l'effet des pluies acides sur différents matériaux en utilisant du vinaigre. Les échantillons sont d'abord pesés, puis immergés dans du vinaigre pour simuler l'érosion, et enfin nous mesurons les masses pour voir quelle quantité de matériau a été perdue. Pour reproduire l'expérience, je pense que nous aurions besoin d'en savoir un peu plus sur les récipients de vinaigre. Il faudrait préciser la taille des récipients et la quantité de vinaigre à utiliser (au moins approximative), ou la proportion de l'échantillon à utiliser. Le type de vinaigre à utiliser doit être connu, c'est-à-dire que sa densité doit être indiquée avec précision. La densité des matériaux est également utile. Ceci est important car si la densité du vinaigre est inférieure à celle des échantillons, ces derniers iront au fond du récipient. À son tour, la profondeur du navire affecte la pression sur les échantillons s'ils coulent. Il est également important de connaître la température initiale du bain de vinaigre. Si elle n'est pas spécifiée, il est entendu qu'elle est à température ambiante, ou à température standard, c'est-à-dire _25 degrés C. Il serait peut-être important de calculer la masse relative perdue par chaque échantillon, c'est-à-dire le rapport entre sa masse finale et sa masse initiale. D'autant plus que les échantillons n'ont pas tous la même masse initiale.
es_3W92K5RLWWU0LSON7JASSOU366G5VR	Quelle quantité de vinaigre verser, quelle est la taille des récipients, comment déterminer la masse.
es_3WJ1OXY92CTZGM4RUMQZ8LQHJY7A88	Données supplémentaires : a. Température dans les conteneurs pendant les _24 heures. b. Type spécifique de chaque matériau. Type spécifique de chaque matériau. Exemple, type de plastique, bois, etc. Quantité de vinaigre utilisée.
es_3WOKGM4L73T601TP91I2G144P2P0O6	Pour avoir un résultat plus robuste, il est nécessaire de répliquer, d'avoir au moins _3 tests de chaque.
es_3WR9XG3T65OGEJJRBGO2HI8MK0W74U	1. quel type de récipient a été utilisé. Quel type de vinaigre a été utilisé. 3. 3. le nombre total d'échantillons utilisés.
es_3WR9XG3T65OGEJJRBGO2HI8MLXF748	Laissez-en un vide pour voir les différences. nÉchantillon : verreÉchantillon : métal
es_3WS1NTTKE0PCUOGWAYZCT7VQ1350FZ	Quantité de vinaigre utilisée dans chaque expérience.
es_3WS1NTTKE0PCUOGWAYZCT7VQ2AN0FW	FER, ALUMINIUM, FIBRE
es_3WSELTNVR5FIE6WFXK1UZHM42Y3TA6	Je pense que les informations qui pourraient être incluses pour rendre l'expérience plus précise sont le volume initial du récipient où le vinaigre est placé avec chaque matériau, le volume final après le temps utilisé et la différence totale. Ainsi que la modification du pH (acidité) du vinaigre/des matériaux avant et après l'expérience. Enfin, déterminez si l'expérience a été réalisée au niveau de la mer (en tant que costant affectant l'expérience) ou à une altitude plus élevée affectant la valeur de la gravité et donc la valeur du poids (gr).
es_3WYP994K194D8QJ6HD7HRTCXMBOY6S	Le refroidissement par évaporation se distingue des systèmes de climatisation classiques qui utilisent des cycles de compression de vapeur ou de réfrigération par absorption. Le principe de fonctionnement du refroidissement par évaporation est basé sur l'utilisation de la grande enthalpie de vaporisation de l'eau, en fonction de la surface sur laquelle elle repose.
es_3WYP994K194D8QJ6HD7HRTCXNH76YW	bois, _0,0 ; calcaire, -1,3 ; marbre, -0,4.
es_3WZ36BJEV5TNXG173Y1QUS6ACHPTBW	Il est nécessaire de savoir si les échantillons sont uniquement des matériaux inorganiques ou peuvent également être organiques. Le reste des instructions est clair et il est facile de reproduire l'expérience.
es_3X08E93BHXVBP690BUCP82S4EPN66V	La taille des récipients, la quantité de vinaigre dans les récipients et si les récipients étaient fermés ou non.
es_3X0H8UUIT31E6JM39PSW71N9L8QSW2	J'ai besoin de connaître les limites d'erreur utilisées lors de la mesure des masses. J'ai besoin de connaître la composition chimique exacte des différents échantillons. J'ai besoin de savoir s'il y a eu une erreur humaine.
es_3X4MXAO0BI1254MQU0SRHRID2UTRWE	La quantité de vinaigre dans chaque échantillon, la masse initiale des échantillons, la masse finale des échantillons, et la masse finale des échantillons.
es_3XC1O3LBOUZZAPNJUBQK8V2FSBMLTY	D'abord, j'aimerais savoir quelle est l'hypothèse de l'expérience. Ensuite, il faudrait que je sache quelle quantité de vinaigre mettre dans chaque récipient. Troisièmement, j'aurais besoin de savoir combien de temps il faut rincer chaque échantillon avec de l'eau distillée.
es_3XCC1ODXDNOXL7Q4IRTLP20RFKSQR8	Une description des objectifs et/ou de l'hypothèse de l'expérience. _2. Une liste des matériaux requis, y compris des échantillons. 3. Une description de l'environnement dans lequel l'expérience doit être réalisée, que ce soit dans un lieu ouvert ou dans un laboratoire. Les précautions à prendre.
es_3XM0HYN6NMCNCRKKW8UWQQBYVCREPT	Origine et caractéristiques des échantillons : quel type de bois, quel type de plastique.\NType de vinaigre (acidité).\NCapuchonnage ou non des récipients.
es_3XUHV3NRVMBV3RT32UTODN3UR8CH5B	J'aurais besoin de la quantité de vinaigre qui a été utilisée. J'aurais également besoin de connaître la température des conteneurs pendant les _24 heures. Au final, j'aurais besoin des volumes des échantillons avant et après l'expérience.
es_3YGXWBAF72UMQ0EN2XWDX400F3R4C2	Pour reproduire l'expérience, j'aurais besoin de savoir quelle quantité de vinaigre il faut utiliser. Doit-il recouvrir complètement l'échantillon ? De plus, vous ne précisez pas la forme des échantillons et cela affecte-t-il la surface de contact avec le vinaigre, chaque échantillon est-il un seul bloc de matériau ou plusieurs morceaux ? Et enfin, quel type de vinaigre doit être utilisé, il n'est pas clair pour moi que n'importe quel vinaigre fonctionne de la même manière.
es_3YHH42UU5DSYUGQSW92AOK0A1ZKL0L	déterminer l'acidité du vinaigre et comment il peut corroder le matériau ntester la pureté et la dureté des matériaux nmesurer la température à laquelle les tests sont effectués.
es_3YHH42UU5DSYUGQSW92AOK0AR0AL03	TYPE DE MATÉRIAU QUANTITÉ DE VINAIGRE UTILISÉE MÉTHODE DE SÉCHAGE
es_3YJ6NA41JDTVN76CA95NN6OQWHVPJN	J'aurais besoin des résultats de la première expérience, d'un bâton de mesure pour mesurer le poids exact de chaque échantillon, j'aurais besoin de photos des résultats de la première expérience.
es_3YMTUJH0DUT3CHGYOJR3ME04C8LT4F	Quel type de vinaigre ? Quelle quantité de vinaigre a été utilisée ? Dimensions du récipient ? Les échantillons doivent-ils être entièrement recouverts ? Température ambiante ? Quel type de plastique ? Quel type de bois ? Quel type de calcaire ? Quel type de marbre ?
es_3YZ8UPK3VVZL7Y82H3NVA8YUEE3UCZ	Conditions atmosphériques, quantité de vinaigre par rapport au poids du matériau et précision des matériels de mesure ?
es_3YZ8UPK3VVZL7Y82H3NVA8YUM6MUCA	Dans les échantillons, on a remarqué qu'il y avait une stabilité sans aucune altération, car dans le bois il n'y avait pas de changement dans sa masse, mais dans les autres échantillons il y avait une altération de sa masse.
es_3Z3ZLGNNSK75255271SP74XB64X3QV	la quantité initiale et finale de vinaigre dans chaque récipient. la taille du récipient. le matériau est-il entièrement recouvert ?
es_3Z3ZLGNNSK75255271SP74XBDIX3QU	bois
es_3Z3ZLGNNSK75255271SP74XBDNU3Q1	Combien de vinaigre ? Jusqu'à ce que l'échantillon soit immergé ? Le volume de liquide du vinaigre doit être pesé.
es_3Z4AIRP3C8QT1ZSZ6B9YDJE75MQ1XG	- Quelle quantité de vinaigre mettre dans les récipients - Quel type de vinaigre (vinaigre de pomme, vinaigre de canneberge...) - La taille des récipients.
es_3Z4GS9HPNXNDX61ADEM9KUSW5YF77T	J'aurais besoin du type de bois utilisé, par exemple du pin, du chêne ou autre. \Il en va de même pour le type de récipient en plastique utilisé, qu'il s'agisse d'un sac en plastique ou d'un autre type. \J'aurais également besoin de connaître la température à laquelle se trouvait chaque expérience à ce moment-là ou s'il y avait une sorte de chauffage.
es_3Z4XG4ZF4A4BCZCK5WIDST1FHAQX8O	Le bois est la meilleure masse, suivi du marbre et ensuite du calcaire.
es_3Z4XG4ZF4A4BCZCK5WIDST1FKJ6X8P	J'aurais besoin de savoir : Les caractéristiques chimiques du vinaigre, le matériau des récipients, et s'ils ont été fermés pendant les _24 heures d'attente, ainsi que la composition spécifique de chaque échantillon (bois de quel type ? plastique de quel type ? etc.).
es_3Z7VU45IP0UI6USE7TXJA4UIE7IZ1C	1. J'aurais besoin de savoir si les masses sont solides ou en poudre. 2. J'ai besoin de la température de la pièce où les échantillons ont été soustraits pendant 24 heures et au moment de leur séchage. 3. Quel était le filtre utilisé pour les rincer ? Pour voir s'il était possible que de la matière s'échappe lors du rinçage. Avec quelle quantité d'eau distillée ont-ils été rincés ? Un litre ? 50 litres ?
es_3Z9WI9EOZ11YLAE69HXUFCMCWMSHK1	J'ai besoin des mesures des quatre récipients, de la quantité de vinaigre utilisée, de la surface sur laquelle les échantillons ont été séchés.
es_3ZPBJO59KREQ748WH0B7BZRM9LPDHR	Nous devons savoir quelle quantité de vinaigre a été utilisée. _1.  Nous devons savoir quelle est la surface des échantillons. 3.  Nous devons savoir si le vinaigre couvre complètement l'échantillon.
es_3ZPPDN2SLX92K44DFJYZ40BJL7TE9B	Laissez les échantillons reposer et sécher pour obtenir la masse finale.
es_3ZPPDN2SLX92K44DFJYZ40BJLFTE9R	temps, la quantité de vinaigre utilisée, et la masse utilisée.
es_3ZPPDN2SLX92K44DFJYZ40BJLII9EH	pour savoir quelle quantité de vinaigre mettre et où le stocker, la température, etc.
es_3ZQIG0FLQGTUYB373KX1IO7GT24VWJ	1. Quelle quantité d'eau distillée a été utilisée pour l'expérience?n2. Quel type de vinaigre a été utilisé pour l'expérience ? n3. Quelle quantité de vinaigre a été utilisée pour l'expérience ? n4. Quel récipient avez-vous utilisé pour les échantillons ? n5. Où les échantillons ont-ils été laissés pour sécher ? Au soleil ? Dans une salle de classe ? n6. Tous les échantillons ont-ils été séchés en même temps ? Selon le matériau de l'échantillon, ils peuvent avoir séché plus ou moins rapidement.
es_3ZR9AIQJUDM2W8J7QH3T23YZ9KT04J	Les élèves peuvent réaliser les mêmes procédures d'expérience avec trois matériaux différents : de la ouate, du fer et du bicarbonate de soude.
es_3ZSANO2JCHKCVX08J0IW3D19X9NFST	Pour reproduire l'expérience, mettez l'eau et le vinaigre en même temps car on ne sait pas si la différence vient de l'eau ou du vinaigre. De même, il serait utile d'utiliser des masses différentes car on sait ce qu'est la masse et ce qu'est l'échantillon. Il faut également utiliser des échantillons qui ont le même poids au départ.
es_3ZSY5X72NZOU0VDO3E1H0X5R44XORV	A ma connaissance, je pense que les données suivantes sont nécessaires.nn_1. Quantité de vinaigre utilisée pour chaque échantillon.n2. Volume des conteneurs utilisés.n3. Volume d'eau distillée utilisé.n4. Température à laquelle ces échantillons ont été conservés pendant 24 heures.n5. Il est également important de mentionner si les échantillons ont été conservés au sec pendant 30 minutes à température ambiante ou dans un endroit sec sans entrée d'air.
es_3ZY8KE4ISLGPEE7LRBYVQZPU3PJVQL	Déterminer la masse de chaque échantillon
es_3ZY8KE4ISLGPEE7LRBYVQZPUV6VQVI	-Type de vinaigre utilisé (ph du vinaigre) Type de bois et de plastique utilisé (il y a différents types de bois et de plastique) Géométrie de l'échantillon (tous les échantillons avaient-ils la même géométrie, prisme, sphère, etc.).
