id	text
es_3018Q3ZVOK35YRJNTVWZZ2LMBENRA7	blanc : : L'expérience montre que plus la couleur est claire, plus la température à l'intérieur du chenil est basse. Par conséquent, pour offrir une température plus tolérable au chien pendant la journée, la couleur blanche favorisera une température plus fraîche à l'intérieur du chenil.
es_3018Q3ZVOK35YRJNTVWZZ2LMDXXAR4	blanc : : le blanc peut laisser le chenil à une température plus basse, car il n'augmente pas la température autant que les autres couleurs.
es_304SM51WA5HMIGOSEYW0KNAOI0CSBJ	blanc : : Cela fera paraître la maison plus grande.
es_308Q0PEVBAQE096ZB2OQPF9BKSU9I0	gris clair : : Selon ce tableau, les quatre différents tableaux noir, gris foncé, gris clair, blanc. Mon choix est le gris clair car il est parfait pour la peinture de la maison.
es_308XBLVESKHAH1OFZ9WVUD5SV4ABR6	blanc : : La couleur blanche devient la température la plus basse à l'intérieur de la maison.  L'expérience confirme cette conclusion car la température à l'intérieur du bateau était plus basse avec le blanc par rapport aux autres couleurs (noir, gris, etc.).  Ainsi, lorsqu'il fait chaud, le blanc est pour moi la meilleure couleur pour un abri, mais parce qu'il reflète davantage la lumière lorsqu'il fait chaud.
es_30H4UDGLT4VLOFCXD6IF3YG74D7PMG	blanc : : Plus la couleur utilisée pour la niche du chien est foncée, plus la niche sera chaude car les couleurs foncées absorbent plus d'énergie. Comme le montrent les résultats de l'expérience, plus la couleur est claire, plus la température à l'intérieur du chenil est basse. La couleur la plus claire étant le blanc, il s'agit de la couleur à privilégier car elle permet d'obtenir la température la plus confortable possible pour le chien.
es_30IQTZXKAMJTUA7HAS5YZEVX1AY0XN	blanc : : D'après les résultats, le chenil devrait être blanc car il restera plus frais et le chien ne surchauffera pas.
es_30LB5CDZNENIZ57WBATJWZB87AM0Z8	noir : : J'ai choisi le noir parce qu'il augmente la température de l'air à l'intérieur d'un chenil. Nous verrons comment il affecte les couleurs.
es_30X31N5D653HZ6J08KW4PCQISR8ASX	blanc : : le blanc absorbe moins de lumière, la température à l'intérieur du chenil augmentera donc moins.
es_30ZX6P7VFA8ZV0568BUBRTGXKAC2JR	blanc : : La couleur blanche peut contribuer à faire baisser la température à l'intérieur de la maison, ce qui est une bonne chose dans les climats plus chauds. Comme vous pouvez le constater, la température moyenne avec le couvercle blanc est la plus basse de tous les couvercles de couleur plus foncée.
es_30ZX6P7VFA8ZV0568BUBRTGXKD0J22	gris clair : : Il donnerait plus de luminosité à la maison et maintiendrait une atmosphère plus fraîche à l'intérieur de la maison.
es_317HQ483I95ZPBATCC7V7G4VP67INI	noir : : La couleur noire pourrait affecter l'intérieur de l'abri car les couleurs sombres absorbent plus d'énergie. Dans les tests, la couleur noire a obtenu les meilleurs résultats car elle absorbe plus d'énergie. La moyenne de la couleur noire est de _53.
es_3180JW2OT6PRUXOTQUW9P0J965QJ54	blanc : : Un bâtiment blanc devrait faire en sorte que la température à l'intérieur du bâtiment soit moins affectée par l'extérieur. Ainsi, s'il fait trop chaud dehors, le chien se sentira plus à l'aise à l'intérieur de la niche. S'il fait froid, comme il n'y a pas de source de chaleur à l'extérieur, cela n'a pas d'importance si elle est noire, car elle ne sera pas plus chaude de toute façon.
es_3180JW2OT6PRUXOTQUW9P0J98C25JI	blanc : : La formule générale est que la couleur sombre absorbe la chaleur, donc, selon ce phénomène, le noir augmentera la chaleur.
es_31EUONYN2XGMT2U5CY6R1UUUG7WOVV	gris clair : : Pour donner une réponse plus précise, il faudrait connaître le matériau du bâtiment, mais a priori, selon le même théorème contenu dans l'exercice, c'est-à-dire en considérant que les couleurs foncées absorbent plus d'énergie, et que nous ne savons pas si le bâtiment se trouve dans une zone de chaleur ou de froid extrême, il vaut mieux opter pour une réponse neutre, qui donne le plus de chaleur possible en hiver et le moins de chaleur possible en été.
es_31JLPPHS2W72HTSMSO0LIZ2BT8DO3I	blanc : : Le blanc aura une incidence sur l'intérieur du bâtiment car les couleurs claires n'absorbent pas autant d'énergie que les couleurs plus sombres comme le noir.
es_31JLPPHS2W72HTSMSO0LIZ2BURA3OX	blanc : : La couleur blanche n'absorbe pas autant de chaleur que les autres couleurs, et il est préférable que le chenil ne se réchauffe pas autant pour que le chien ne souffre pas de la chaleur de l'été.
es_31LM9EDVON5VKMUZUUSVJHJV26QJNV	blanc : : J'ai choisi le blanc pour que la température reste confortable en hiver comme en été.
es_31LVTDXBL9NMUAARQMLP8G1X1WARLL	noir : : Utilisez les effets psychologiques du noir pour créer un look élégant et audacieux pour votre maison. S'il est utilisé intelligemment, le noir donne une touche élégante et sophistiquée à la décoration intérieure. Sur un fond de couleur claire ou neutre, tout ce qui est noir ressort. Le noir est idéal pour mettre en valeur certaines choses dans une pièce. La plupart des gens associent le noir à la mort, au deuil, au veuvage et, en général, à des occasions formelles et sérieuses. En conclusion, n'utilisez pas trop de noir, mais seulement pour mettre en valeur certaines choses comme les cadres de photos, les petites tables, etc.
es_31LVTDXBL9NMUAARQMLP8G1X2TCRLI	noir : : CETTE EXPÉRIENCE A PERMIS DE CONCLURE QUE L'INTÉRIEUR ÉTAIT AUSSI TROP CHAUFFÉ PAR CETTE LAMPE ET SA TEMPÉRATURE PLUS ÉLEVÉE. LA LUMINOSITÉ DE L'INTÉRIEUR A ÉTÉ AFFECTÉE.
es_31Q0U3WYDRSZMKM8OY50JK1J80W71V	gris foncé : : Selon ce tableau, les quatre différents tableaux noir, gris foncé, gris clair, blanc Mon choix est le gris clair car il est parfait pour la peinture de maison.
es_31QNSG6A5T6HXK6TNJEFYUORGDU87G	blanc : : La couleur blanche reflète davantage la lumière, de sorte que la température n'augmente pas trop lorsque le chien est dans la niche par temps chaud.
es_31UV0MXWNSPVZM4N8CB9DZ49WBL5I7	blanc : : C'est la couleur qui réchauffera le moins le chenil, l'expérience confirmant l'hypothèse initiale selon laquelle plus la couleur est foncée, plus elle absorbe d'énergie. Avec un chenil blanc, le chien aurait un abri plus frais lors des journées ensoleillées.
es_326O153BMKBENUHURZ31QWU9F01ED4	gris foncé : : Le gris foncé permet de consommer moins d'énergie, quelle que soit l'heure de la journée à laquelle le chenil est exposé au soleil. Les climatiseurs ou les chauffages ont besoin de beaucoup d'électricité pour maintenir un espace à une température stable pendant le jour et la nuit. Si tous les tests ont commencé avec une température de _24C et que les températures ont ensuite été enregistrées à des moments différents, la couleur grise n'a pas été affectée, quelle que soit la durée d'exposition du couvercle à la lumière créant de la chaleur. On peut comparer cela à l'ensoleillement d'un bâtiment et au nombre d'heures d'exposition au soleil de ce bâtiment.
es_32EYX73OY2MPD0XLZ0DQZ3XGEKEURN	blanc : : Avec l'incidence de la chaleur, la température n'augmente pas autant que les autres couleurs.
es_32KTQ2V7RFS0WSWQWHMIH8GS19NM9I	blanc : : Le blanc fait en sorte que la température du chenil augmente le moins possible, avec une moyenne de _42º.
es_32KTQ2V7RFS0WSWQWHMIH8GSU9M9MX	noir : : Parce que votre chien aimerait avoir chaud, le noir est la meilleure couleur pour le chenil. Les résultats de l'expérience montrent que le noir absorbe plus d'énergie, car la température du couvercle noir a davantage augmenté.
es_32M8BPYGAVZTFJT7P8U0HWVYIFDIG2	blanc : : Le blanc permet de garder la température de la maison beaucoup plus fraîche toute l'année. Comme le montre le graphique ci-dessus, il s'agit de la température la plus froide sur toutes les échelles. Le blanc a un albédo élevé, ce qui signifie qu'il garde les températures fraîches.
es_32RIADZISUH2XH3JZJMDC94I07D4SX	blanc : : Le blanc réduit le réchauffement du soleil à l'intérieur de la niche et le chien sera plus confortable.
es_32RIADZISUH2XH3JZJMDC94I08B4SX	blanc : : En peignant le chenil en blanc, il n'y aura pas une augmentation aussi importante de la température à l'intérieur du chenil s'il est exposé à une lumière solaire intense ou à une lumière artificielle.
es_32SCWG5HIJHJZCR5QQBYE2JL9DO6PE	blanc : : La couleur blanche réfléchit moins la chaleur à l'intérieur du bâtiment, il faut donc peindre le bâtiment en blanc pour faire baisser la température à l'intérieur du bâtiment.
es_32SVAV9L3HMDFPYLI5V3H4I671K3AW	noir : : La couleur noire fait que la température de l'air à l'intérieur de la boîte est plus élevée, l'expérience prouve que votre hypothèse était correcte puisque la température était plus élevée et que la boîte absorbe donc plus d'énergie.
es_32UTUBMZ7I92A85W8T15VAUVA57BV3	gris clair : : La couleur gris clair rendrait la température à l'intérieur de la cabane plus élevée, mais pas tant que ça. Les résultats de l'expérience montrent que si la couleur est le noir, la température augmente de plus de deux fois la température initiale, mais que le gris clair est un peu moins de deux fois la température initiale.
es_32ZKVD547H0IYZ3DOJVZCF2CL9U3BS	blanc : : La maison sera toujours moins chaude à cause de la couleur blanche. Il n'absorbera pas autant de lumière solaire.
es_32ZKVD547H0IYZ3DOJVZCF2CNTK3BO	blanc : : En utilisant le blanc, la température à l'intérieur du chenil restera plus fraîche et plus agréable pour le chien.
es_336YQZE83XRHV5UETR915SBQC7QM5Y	blanc : : D'après les résultats, plus la couleur est claire, moins elle absorbe d'énergie. La couleur blanche a une température plus basse que la couleur noire.
es_337RC3OW07FENHR8Z6QZ9DQ0M1BVL4	blanc : : Selon l'expérience, les couleurs des objets influent sur la température des espaces qu'ils contiennent, montrant que les couleurs claires comme le blanc ralentissent le réchauffement de l'air contenu dans un objet, par opposition aux couleurs sombres comme le noir qui accélèrent le réchauffement de l'air contenu dans un objet.
es_338JKRMM28CS9X5KXQK5LYJGR9LAH0	blanc : : Selon l'expérience, le blanc est la couleur qui maintient la température de l'air plus basse, par rapport aux autres couleurs, gris, gris foncé ou noir. Donc si vous voulez maintenir une température fraîche dans la maison, j'opterais pour le blanc.
es_33CID571066UB8PPFWKTQIYHUEG3L6	blanc : : La couleur blanche aura un effet sur le chenil en réfléchissant la lumière du soleil et en maintenant ainsi l'intérieur à une température fraîche, sans le risque éventuel de surchauffer l'air et d'étouffer l'animal. Comme on peut le voir dans le tableau, la couleur blanche présente les résultats les plus bas en termes de température, tandis que, à mesure que l'obscurité de la couleur augmente, la température augmente également, atteignant jusqu'à _54ºC.
es_33CKWXB73LXLBY76ZIORIAA6YV711U	blanc : : Les matériaux de couleur blanche reflètent davantage l'énergie lumineuse et la chaleur que ceux de couleur plus foncée. Par conséquent, une construction faite de matériaux plus légers aura une température intérieure plus basse qu'une construction faite de matériaux plus sombres. Cela est clairement démontré dans l'expérience, puisque le bidon avec le couvercle blanc a atteint une température moyenne de seulement _42°C dans les trois expériences répétées. Le bidon avec le couvercle noir, cependant, a atteint 53°C dans trois expériences. Les bidons avec des couvercles gris clair et gris foncé avaient des températures intermédiaires, comme prévu.
es_33F859I568QXS7AC34K1G93M3X8BH4	blanc : : L'expérience a démontré que les objets peints en blanc sont ceux dont la température intérieure a le moins augmenté, puisqu'ils n'ont augmenté que de _18 °C pendant l'exposition. Étant donné qu'il s'agira d'une maison pour un chien, qui a plus de mal à réguler sa température, il est plus pratique qu'elle n'augmente pas trop.
es_33FOTY3KEOY5Y1H4FFDBZ6TX3JA1CF	blanc : : Avec le couvercle blanc, la température de l'air à l'intérieur de la boîte a obtenu les valeurs les plus basses dans tous les tests. On suppose donc que dans une hutte, il obtiendrait des résultats similaires.
es_33ISQZVXPRZPL4R2VC2VG2CO716CCR	gris clair : : SELON LE CLIMAT, IL EST BON DE SAVOIR QU'ELLE EST LA MEILLEURE TEMPERATURE POUR LE CHIEN, LA DISTANCE DE LA LAMPE EST AUSSI UN FACTEUR DETERMINANT, JE Mettrais une couleur neutre où la température ne varie pas beaucoup. ! !!!
es_33ISQZVXPRZPL4R2VC2VG2CO728CCV	blanc : : L'énergie lumineuse peut être absorbée ou réfléchie. Les surfaces et les objets sombres absorbent la lumière et la convertissent en énergie thermique, ce qui donne l'impression que la température de cet objet est plus élevée. L'objectif de notre chenil est d'empêcher autant que possible le transfert de chaleur afin de garder notre chiot au frais. En gardant la chaleur à l'intérieur, nous rendons l'intérieur plus frais. Le chenil blanc reflète davantage la lumière que les couleurs plus sombres. Le chenil blanc devrait être le plus frais à l'intérieur. La niche noire absorbe le plus de lumière, et cette énergie est transférée à l'intérieur de la niche au fil du temps et réchauffe l'intérieur.
es_33IZTU6J83ETVJRTJUOI9K1G1MUXST	blanc : : La couleur blanche maintient la température de l'air à l'intérieur de la cabine très fraîche.
es_33IZTU6J83ETVJRTJUOI9K1GXNVSXN	blanc : : le blanc absorbe la chaleur et pour cette raison, c'est la meilleure couleur pour la peinture de la cabine. Comme vous pouvez le constater, les températures de l'air avec la couleur blanche sont les meilleures.
es_33LKR6A5KGXMKIJF1181OGT1VA71T9	blanc : : le blanc est la couleur idéale car une chaleur trop importante n'est jamais bonne pour le chien.
es_33PPUNGG3AI6ZZRV5NCYGVCVMHIZR6	blanc : : D'après les informations fournies dans le tableau, le blanc est la couleur qui absorbe le moins de chaleur et maintient la température en dessous de _45 degrés centigrades selon les résultats. Le blanc est le meilleur choix pour Brandi et Jerry.
es_33TIN5LC06N0Q9L4FKATB33ZAK99Y5	blanc : : Le blanc rendrait l'intérieur du chenil plus froid que les autres couleurs. D'après les données, le blanc abaisse davantage la température interne que les autres couleurs.
es_33UKMF931BXNT2VO3KSBUMCWQO2TT7	blanc : : couleur blanche car elle absorbe moins d'énergie thermique, la température à l'intérieur du chenil sera donc plus basse.
es_34BBWHLWHCOPC5J74DYI3ZHMF5OWI7	blanc : : Dans un endroit chaud, avec beaucoup de soleil, une couleur claire ou blanche rendrait la température à l'intérieur du chenil aussi basse que possible, avec une différence allant jusqu'à _12º par rapport à une couleur noire.  Selon l'emplacement du chenil, on peut également avoir intérêt à le peindre d'une couleur sombre pour augmenter cette température.
es_34FNN24DCOMHPMJSCUXCZNYXHNO5YZ	noir : : D'après les tests effectués, il est évident que la couleur noire a augmenté la température de manière significative plus que les autres couleurs. En effet, plus la couleur est foncée, plus l'objet de cette couleur absorbe d'énergie.
es_34FNN24DCOMHPMJSCUXCZNYXHZGY58	blanc : : La couleur blanche n'absorbe pas autant d'énergie, la cabane n'emprisonne donc pas autant de chaleur. C'est un bon choix si Jerry et Brandi vivent dans un climat très chaud. Si c'est pour un climat froid, le noir serait plus efficace et idéal.
es_34FNN24DCOMHPMJSCUXCZNYXLCB5Y4	blanc : : La couleur blanche rendra la niche plus fraîche en été.
es_34HJIJKLP79IP9KNTERINWOPZAPV49	blanc : : Le blanc repousse plus d'énergie que les couleurs sombres. L'utilisation d'un toit blanc semble donc être la meilleure mesure pour maintenir la niche à une température plus basse.
es_34HJIJKLP79IP9KNTERINWOPZILV4L	blanc : : Le blanc est le meilleur choix pour la niche du chien, il permet de garder la maison plus fraîche car le blanc n'absorbe pas autant d'énergie que le noir.
es_34MAJL3QP60YD0I494LC41W681F34P	gris clair : : avec cette couleur, une température moyenne d'environ _45 degrés est possible selon le tableau d'expérience fourni. Peut-être une température appropriée pour un chien et considérant que la lumière dans le test fait la fonction du soleil...
es_34PGFRQONQOL7G3DMVJIF0WMPE7WJY	blanc : : la couleur blanche fait baisser la température à l'intérieur du chenil.
es_34Q075JO1ZQL49MO3ZKR45RWT4110T	blanc : : Comme les couleurs sombres absorbent plus d'énergie et réchauffent l'air à l'intérieur du chenil, choisir de peindre le chenil en blanc permet d'obtenir un chenil plus frais.
es_34QN5IT0T143F9692KT6JFE477Y805	blanc : : Le blanc est la seule couleur qui maintient une température de _43 oh moins, le blanc est la couleur qui absorbe le moins la chaleur du soleil. Il est plus pratique d'avoir une maison blanche afin qu'elle ne retienne pas autant de chaleur pendant l'été.
es_34QN5IT0T143F9692KT6JFE4CUG08U	blanc : : Selon les résultats de l'expérience. Le couvercle blanc est celui qui isole ou reflète la chaleur émise par la lampe. Un chenil pour un animal de compagnie devrait donc avoir un toit de cette couleur, si vous voulez que le chien soit confortable. Il convient toutefois de définir si le chenil doit être utilisé dans des climats tempérés ou hivernaux.
es_34S9DKFK752LFBPYGUTYT4YJEU6YNE	blanc : : Les couleurs sombres absorbent plus d'énergie, selon les résultats de cette étude. Le blanc absorbe moins d'énergie et, par conséquent, est moins chaud et l'intérieur du chenil sera plus frais et moins chaud.
es_34T446B1C2R5RCWMJW9BL1AN5TW0CE	blanc : : Parce que si vous peignez le chenil en noir, il fera trop chaud à l'intérieur. La couleur blanche est meilleure car la température sera maintenue plus basse.
es_34V1S5K3GUEY7PBY91F1SCJ64DX96L	gris clair : : Je choisirais le gris clair car en été il ne fera pas aussi chaud et en hiver ce ne sera pas idéal mais au moins il ne fera pas aussi froid qu'avec le blanc, plus la couleur choisie est noire plus la maison sera chaude.
es_34V1S5K3GUEY7PBY91F1SCJ683896G	blanc : : Comme prévu pour cette expérience, les données recueillies montrent que les couleurs sombres absorbent plus d'énergie que les couleurs claires. La couleur blanche absorbe le moins de rayonnement. La maison blanche aura la plus faible augmentation de température lorsqu'elle sera exposée au soleil.
es_34X6J5FLPVBGNJ7RAMKCNBE03JPQJ1	blanc : : La couleur blanche ou les couleurs claires en général font que dans le chenil il y a moins de température et puisque nous construisons un chenil pour un chien, l'idéal est qu'il soit de couleur claire, pour que l'animal ait la température la plus agréable possible. Si nous utilisions une couleur sombre la température augmenterait à plus du double, de la température extérieure, comme il est reflété dans l'expérience avec la lampe.
es_351SEKWQS2UCZI978XRK34ZILU7MDX	blanc : : La couleur blanche maintient la température de la maison à un niveau plus bas que toutes les autres couleurs. Dans les trois tests, la couleur blanche a toujours été celle qui a atteint la température la plus basse.
es_352YTHGROXQD78P3OPAE8VXGV0S4HK	black : : Noir
es_352YTHGROXQD78P3OPAE8VXGYDI4H3	blanc : : Cette couleur permet d'éviter que la température à l'intérieur du chenil ne soit trop élevée, surtout en été.
es_354P56DE9MGZG4L21HKKFLOSR8H7SW	blanc : : D'après l'expérience, je dirais que le blanc est la bonne couleur car il n'absorbe pas beaucoup d'énergie.
es_354P56DE9MGZG4L21HKKFLOSSBAS7H	white : : Blanc
es_358010RM5G69NB8XDPTNK7LNS8OXVQ	blanc : : La température à l'intérieur de la maison doit être plus basse qu'avec les autres couleurs.
es_358010RM5G69NB8XDPTNK7LNU96XVC	blanc : : La meilleure couleur pour le chenil est le blanc, car il fait baisser la température dans le chenil. Le chien étant un être vivant, il est important que le chenil soit à une température confortable.
es_35GMH2SV3GU5RR8JH8HH1Q68MYXOE7	noir : : Je pense que cette couleur est plus pleine de vert que les autres.
es_35H6S234SCDF629M6B2KGWE4IGZ65A	blanc : : La couleur blanche permet de conserver une température plus basse dans le chenil qu'une couleur foncée.
es_35H6S234SCDF629M6B2KGWE4KN356T	blanc : : Les températures obtenues en utilisant la couleur blanche sont les plus basses, mais elles vont de _41 à 43 degrés centigrades, ce qui est une température très élevée pour un chien dans un chenil.
es_35K3O9HUADQBLEVQI5YREWXUOC5FEZ	blanc : : Dans l'expérience, le couvercle blanc était celui qui entraînait une température plus basse à l'intérieur du chenil. Par conséquent, si le chenil est peint en blanc, la température à l'intérieur du chenil n'augmentera pas autant qu'avec l'une des autres couleurs.
es_35K3O9HUADQBLEVQI5YREWXUP47FEM	blanc : : En utilisant le blanc, la température à l'intérieur de la maison restera plus fraîche que si des couleurs sombres sont utilisées.
es_35L9RVQFCQVCO6JI3V1WLZVAWKVHUF	blanc : : La meilleure couleur est sans aucun doute le blanc, car il absorbe moins la chaleur que les couleurs plus sombres. Le blanc pourrait être une bonne couleur à utiliser car en été, lorsque les températures sont généralement élevées, le chenil ne deviendra pas trop chaud. En effet, la lumière qui tombe sur des surfaces claires est réfléchie, tandis que celle qui tombe sur des couleurs sombres est absorbée. Cela explique pourquoi, dans notre expérience, plus la couleur est foncée, plus la température à l'intérieur du récipient est élevée.
es_35L9RVQFCQVCO6JI3V1WLZVAXOPUHV	blanc : : CONSIDERER AUX BANOS
es_35L9RVQFCQVCO6JI3V1WLZVAY8YHUW	blanc : : L'utilisation d'un couvercle blanc permettra d'éviter qu'il fasse trop chaud à l'intérieur de la maison. Lors de l'expérience, le bocal en verre avec le couvercle blanc n'a atteint que _42 degrés, tandis que le bocal en verre avec le couvercle noir a atteint 53 degrés, il serait donc préférable pour le chien que j'utilise le couvercle blanc. Ce serait plus cool.
es_36AHBNMV1TPCTZYLR0FVXZMPX0PDYD	blanc : : La meilleure couleur pour la niche de votre chien est le blanc, car c'est là que les températures sont les plus basses, avec une moyenne de _42ºC.
es_36H9ULYP647JWUHIW69IBCAMTDUJF3	gris foncé : : La meilleure couleur serait le gris foncé car si la température augmente plus qu'avec le blanc, avec le gris elle reste constante, ce qui est également utile pour les mois d'hiver car elle ne se refroidit pas si vite.
es_36H9ULYP647JWUHIW69IBCAMTEDFJK	blanc : : L'hypothèse de l'expérience a été testée : les couleurs foncées absorbent plus de chaleur, et il s'est avéré que l'intérieur de la casserole était plus chaud avec le couvercle noir qu'avec le couvercle gris foncé, et que le couvercle gris foncé était plus chaud que la casserole avec le couvercle gris clair, et ainsi de suite. Si je devais concevoir un chenil pour un chien, je voudrais lui donner une couleur plus claire afin que l'intérieur chauffe le moins possible.
es_36NEMU28XHQB8O9YPSWAVSO3SL7MWM	blanc : : comme les couleurs foncées absorbent plus d'énergie, en utilisant le blanc nous permettons une température plus basse à l'intérieur du chenil.
es_36PW28KO419GPNEI7PCZ0VM3Y8NEAB	light grey : : Light grey parce qu'après les trois tests et le dernier avec la moyenne, il ressort comme le meilleur.
es_36TFCYNS46N45ADD80CJ56UEKQQHXR	blanc : : La température de la maison serait plus basse car le blanc attire moins l'énergie.
es_36V4Q8R5ZMD6ORDCDJX4336H4CPMQ1	blanc : : Cette couleur absorbe moins d'énergie et la température n'est pas aussi élevée, il est donc plus essentiel pour le chien de s'adapter à son nouveau foyer. S'il faisait sombre, la niche absorberait plus d'énergie et la niche se réchaufferait plus vite et le pauvre chien tomberait malade à cause de la chaleur.
es_36V4Q8R5ZMD6ORDCDJX4336H4HQQMG	blanc : : Peindre la maison en blanc permet de réfléchir la plupart des radiations du soleil vers l'extérieur, ce qui rend les matériaux de la maison moins chauds et permet à la chaleur de moins passer dans la maison, ce qui la rend plus fraîche et réduit les chances que le chien veuille quitter la maison pour aller dans celle des propriétaires. Dans l'expérience, le couvercle blanc a permis à l'intérieur de la boîte de chauffer le moins possible, indiquant que la peinture blanche permettrait à la maison de chauffer moins que les autres couleurs.
es_36V4Q8R5ZMD6ORDCDJX4336HB55QME	blanc : : la couleur reflète mieux la lumière
es_36W0OB37HYRTA5DS9I042RAPVW9ZH6	blanc : : LE BLANC EST PARFAIT POUR LE MEILLEUR DES CHOSES
es_36ZN444YTTBH7WA5DR78M540B2TIOI	noir : : la couleur noire a maintenu la température la plus élevée.
es_373ERPL3YQLADNIWZVNGU7BEZYRRT1	blanc : : Selon les expériences, la couleur blanche est plus efficace que les autres couleurs, ce qui aide à garder l'intérieur de la maison au frais. Tous les résultats de l'expérience montrent qu'elle absorbe moins de chaleur que les autres.
es_374TNBHA8D86I82QWMLFXYTOJW4QYM	Blanc : : Il ne s'agit pas d'augmenter la température, mais d'absorber et de réfléchir la lumière. La couleur qui a une longueur d'onde élevée absorbe plus de lumière et se transforme en chaleur, tandis que les couleurs à faible longueur d'onde réfléchissent les lumières.
es_379J5II41QTXL65M4G1P992EQEWLEW	blanc : : Plus la couleur de l'abri est foncée, moins la température de l'air à l'intérieur de l'abri augmente.  Si le soleil brille et qu'il fait chaud dehors, l'intérieur d'un chenil blanc maintient une température plus basse qu'un chenil gris ou noir.  Bien sûr, si nous parlons d'un climat froid, il est probablement préférable de choisir le noir pour augmenter la température à l'intérieur de la maison.
es_37C0GNLMHHGAAFOFLHK3E82WVUND69	noir : : La couleur noire aura un effet positif car la température de l'air sera plus élevée avec la couleur noire.
es_37Q970SNZGLL5I60C13BEBXFQASS19	blanc : : La couleur blanche sera meilleure pour votre chien car elle augmentera moins la température que la couleur noire ou les autres. Comme le dit l'hypothèse, plus la couleur est foncée, plus elle absorbe d'énergie et plus elle se réchauffe.
es_37Q970SNZGLL5I60C13BEBXFSGW1S0	noir : : c'est comme ça que ça s'est passé.
es_37TD41K0AJM5SLGYSYSVV7G6ZRPCSY	blanc : : La couleur blanche est celle qui a généré le moins d'augmentation de température, c'est donc la couleur la plus appropriée pour peindre le chenil, afin que le chien ne soit pas soumis à une température trop élevée.
es_37W3JXSD68LB25YC8VKLPNBA8R9WY9	blanc : : Comme il n'est pas de couleur foncée, il contribuera à réduire la chaleur à l'intérieur du chenil. Cependant, vous devez tenir compte des caractéristiques du chien, de sa fourrure.
es_37WLF8U1WR3IOLUPDY6QILXMF3X6KS	blanc : : il ferait plus frais, il ferait moins chaud.
es_37ZHEEHM6YZVWN0NB2JJ7DGG2KG37L	blanc : : Selon les résultats, le blanc est la couleur qui résiste le mieux à la chaleur extérieure et doit donc être utilisé pour le toit de la maison.
es_384PI804XUELYTLIGIZB06E5MVS0SB	gris clair : : Le gris clair serait le meilleur car les deux couleurs plus foncées signifieraient qu'avec la quantité de lumière en été la quantité de chaleur à l'intérieur de la maison serait très élevée, tandis qu'en hiver, quand il y a moins de lumière, le blanc serait trop faible pour donner assez de lumière pour bien chauffer la maison.
es_386PBUZZXHA5WMREIHCG6PF6QDSLJU	gris clair : : Il existe une expérience domestique classique qui consiste à placer une bougie dans un plat avec un ... Trois phénomènes se produisent à l'intérieur du verre pendant que la bougie brûle : ... L'eau monte donc pour remplir le vide, qui représente _1/5 du volume initial. ... Comme vous pouvez le voir dans l'expérience, la pression ne change pas ...
es_38F5OAUN5PPAQV7MQN8LB7HQQQCH7R	blanc : : semble plus clair
es_38SKSKU7R3A91B780ZRGUO06FXVLIA	noir : : peut rendre l'environnement plus sombre à un certain point de vue
es_38YMOXR4MWC9JLO62CPT6WRH6AW6WI	noir : : En fait, la couleur noire attire davantage de particules de lumière (photons), ce qui fait que son attraction thermique augmente plus rapidement et que son gradient thermique augmente également.
es_38YMOXR4MWC9JLO62CPT6WRH76YW63	blanc : : La couleur blanche aide à maintenir la température de la maison plus basse. Pour le vérifier, il suffit de regarder le tableau des températures moyennes.
es_392CY0QWG34D330NU7SZ87YVRD6I4M	gris clair : : gris clair _46
es_39ASUFLU6ZKSL0MBIZ4DK3X1SA6XEZ	blanc : : Le blanc n'absorbe pas la chaleur, il contribue donc à maintenir la pièce plus fraîche.
es_39JEC7537WELKDX2MTX06U0DRVXCVA	gris foncé : : le gris foncé est plus stable.
es_39JEC7537WELKDX2MTX06U0DW6PVCC	blanc : : J'aime beaucoup le blanc. C'est une couleur très pure et très belle pour l'âme et les yeux.
es_39KFRKBFIP83XWPAH9TB8TYO2Q3YOR	blanc : : Avec un chenil peint en blanc, le chien sera soumis à des températures moins extrêmes lors des journées ensoleillées.
es_39LNWE0K4W9CK1U29DJHLBWPXTVUIZ	blanc : : Le blanc serait la couleur idéale pour le chenil du chien car, d'après l'expérience, il subit la plus faible augmentation de température.
es_39LOEL67OUIZW156L7BPLDCBBFA38G	gris clair : : il est très évident qu'il peut être affecté drastiquement et c'est tout commun mon avis est clair et scientifique c'est mon verdict il est vrai cette lumière et ses composants.
es_39LOEL67OUIZW156L7BPLDCBEE583H	blanc : : LA COULEUR DE BALNCO EST TRES EFFICACE PARCE QU'ELLE EST MINGLE DANS LE TEST _42,43 C'EST UNE COMBINAISON TRES ATTRACTIVE ET PRUBA 3 DE 41 EST AUSSI LUMINEUSE DU RESULTAT, ET SA COULEUR PARFAITE DE CHIEN ET MIDA DE 42 EST TRES FINIE DE CHIEN
es_39O5D9O87V5184VJ2JRUNZ8U1DLC3Z	gris foncé : : De toutes les couleurs utilisées dans l'expérience, c'est celle qui offre une température moyenne, elle conviendra donc aussi bien aux conditions de température extérieure chaude que froide.
es_39RP059MEJ6JKLBNU10E8EBIPS8BM1	blanc : : Plus la température est élevée, plus l'inconfort de l'environnement est important.
es_39U1BHVTDN4IULXUO5MKC98YOWU3TB	blanc : : Le blanc n'absorbe pas la lumière autant que les autres couleurs, mais la reflète davantage.  Lorsque la lumière n'est pas absorbée, elle ne se réchauffe pas autant. C'est pourquoi les expériences avec de la peinture blanche ont les températures les plus basses.
es_39ZSFO5CAA98FCE8RV4HXCBP358JUB	blanc : : Si Brandi et Jerry vivent dans un climat chaud, la couleur la plus appropriée est le blanc, car la température à l'intérieur du chenil n'augmentera pas autant pendant les journées ensoleillées et il restera un peu plus frais. S'ils peignent le chenil d'une couleur sombre, le chenil peut devenir insupportable à vivre pendant l'été. L'autre option est que si Brandi et Jerry vivent dans un climat plus froid et moins ensoleillé, il serait préférable de peindre la maison en noir afin qu'en hiver, lors des journées ensoleillées, la maison puisse maintenir une température intérieure légèrement plus élevée.
es_3A0EX8ZRNA1JE201D4OP29YPUUFYBN	gris clair : : Supposons que je décide de faire pousser des germes de soja dans ma cuisine, près de la fenêtre. Je sème quelques graines de soja dans un pot avec de la terre, je les mets sur le rebord de la fenêtre et j'attends qu'elles germent. Cependant, après plusieurs semaines, il n'y a pas de germination. Pourquoi ? Eh bien... il s'avère que j'ai oublié d'arroser les graines.
es_3A4NIXBJ78CVXUXZLEP8MH7NW3DLMI	noir : : La maison serait plus chaude à l'intérieur si elle était noire. Les résultats de l'expérience confirment cette conclusion car ils montrent que plus la couleur du couvercle est foncée, plus la température de l'air à l'intérieur du bocal est élevée.
es_3A4NIXBJ78CVXUXZLEP8MH7NYWSLML	blanc : : L'expérience montre que plus la couleur est claire, moins la chaleur s'accumule à l'intérieur. Par conséquent, la meilleure couleur pour le toit de la niche du chien est le blanc. Cependant, la température minimale atteinte lors de l'expérience (_41°C) est trop élevée pour qu'un être vivant puisse la supporter pendant une période prolongée.
es_3A4TN5196MVG2C2IH4GWRT94JAAHC1	blanc : : La couleur la plus appropriée serait le blanc, car c'est la couleur qui maintient la température la plus basse, l'utilisation des autres couleurs dans l'expérience rendrait la niche trop chaude.
es_3A9AA95ATYZNG8RRL71TMW5LFGUP5W	blanc : : Grâce à l'expérience, on peut voir que le blanc est le meilleur choix car, après _10 min d'exposition à la lampe, cette couleur absorbe moins de chaleur que les couleurs sombres.
es_3AMYWKA6YDZ1ECF4BQYJP2EV072O6O	blanc : : Pendant les saisons chaudes et ensoleillées, la meilleure couleur à utiliser serait le blanc, car après l'expérience, les résultats montrent que c'est la couleur qui absorbe le moins d'énergie de la lampe. Le chien sera confortable pendant l'été en vivant dans sa niche.
es_3AMYWKA6YDZ1ECF4BQYJP2EV1YEO6J	noir : : La couleur noire maximise la température interne et pourrait être utile en hiver.
es_3AMYWKA6YDZ1ECF4BQYJP2EV4WX6OJ	blanc : : Le blanc est la couleur qui apportera les meilleurs bénéfices au chenil car elle absorbe le moins de chaleur étant donné que c'est la couleur la plus claire. Les couleurs sombres absorbent la lumière et cela affecte directement la température, alors que les couleurs claires, dans ce cas le blanc, reflètent la lumière et absorbent moins de chaleur.
es_3AQF3RZ55AV78Z2BCNFT285HBTY6FK	"gris clair : : Il existe une expérience domestique classique qui consiste à mettre une bougie dans un plat avec un peu d'eau et à le recouvrir d'un verre. La bougie consomme de l'oxygène jusqu'à ce qu'elle s'éteigne, et l'eau va dans le verre, puisque la pression y a beaucoup diminué. Elle sort toujours, elle sort très bien et elle est très reconnaissante... ce qui n'est pas si clair, c'est ce qui se passe réellement, et quelle est la raison de cette variation de pression. Javier Fernández Panadero, il y a quelques jours, a publié un article à ce sujet dans Naukas (voir) en précisant que l'explication ""classique"" n'est pas la bonne."
es_3ATTHHXXWC1415OXEIU45IVTPQRXI1	white : : La température change en fonction de la couleur : si le noir fait monter la température, le blanc la fait baisser.
es_3AUQQEL7U761QL2MAD4GBTYCMX3V0P	white : : Les résultats indiquent que le blanc provoque la température la plus basse. Il convient donc d'utiliser le blanc.
es_3B1NLC6UG19LW5GB23KKQTWA316GPP	noir : : noir car il sera plus chaud pour le chien.
es_3B1NLC6UG19LW5GB23KKQTWA40TPGK	blanc : : Le blanc peut rendre la maison plus fraîche quand il fait chaud dehors et le chien n'aura pas trop chaud.
es_3B837J3LDQ99YN5HAVIQK2FSTOZSRD	gris foncé : : La température à l'intérieur du bateau va augmenter.
es_3BC8WZX3V59XX854V6ILUSAW8KBRRG	blanc : : Le blanc serait la meilleure couleur pour la niche du chien car il n'absorbe pas autant de chaleur et de lumière que les autres couleurs utilisées dans l'expérience. Le chenil ne sera pas aussi chaud à l'intérieur si le chenil est peint en blanc. Dans l'expérience, le sommet blanc n'avait qu'une moyenne de _42 degrés C alors que les autres avaient une moyenne plus élevée que le sommet blanc.
es_3BDCF01OGZ7VRBMD4HDJGCUU4CFLYT	blanc : : la température augmente quelle que soit la couleur, mais la couleur blanche augmente la température de moins de degrés. Ce serait plus confortable pour le chien dans le chenil dans un climat chaud.
es_3BQU611VFRXLP8DW78IDCMA806999Q	blanc : : lorsqu'il est peint en blanc, les rayons du soleil sont plus réfléchis, donc la quantité de chaleur absorbée est moindre, ce qui est évident dans le tableau ci-dessus, il est donc préférable de peindre en blanc pour réduire la température à l'intérieur du chenil.
es_3BQU611VFRXLP8DW78IDCMA8Y8K993	gris clair : : si c'est l'été, la température ne sera pas si élevée à l'intérieur de la niche du chien. Si c'est l'hiver, cela lui permettra de se réchauffer un peu plus que s'il avait un chenil blanc. Je considère que le gris clair est neutre
es_3BWI6RSP7IMY6LGK0M0FQ4KDS7ZE7B	blanc : : Je choisirais le blanc car il absorbe moins d'énergie, ce qui contribuera à maintenir la température à l'intérieur du chenil plus fraîche pour le chien.
es_3BXQMRHWK1BYGKKTUSH9D436785UMA	blanc : : Le blanc serait la couleur la plus appropriée car c'est celle qui garde la température plus fraîche, de sorte que l'environnement ne devient pas trop chaud.
es_3C5W7UE9CH3QXOEOZXSWXB2A1FKMX6	blanc : : Les peintures de couleur blanche abaissent la température du chenil de dix à douze degrés, il est donc préférable d'avoir des peintures blanches ou gris clair.
es_3CCZ6YKWR9W2OLBK4I5W0656BM095U	blanc : : Les résultats de l'expérience prouvent que la couleur blanche retient moins d'énergie. Le blanc serait donc la couleur la plus appropriée pour l'abri.
es_3CFJTT4SXV3AMQI6W5Q6BJI5JKK7IU	blanc : : Le blanc est la meilleure couleur pour que l'intérieur de l'abri ne soit pas trop chaud. La température moyenne du blanc était la plus basse de l'expérience (_42C) et plus la couleur est foncée, plus la température est élevée.
es_3CFVK00FWNYT8RC7YYIRXLA144G6LB	gris clair : : Le gris clair est une couleur neutre et la température se situe donc à un niveau moyen.
es_3CFVK00FWNYT8RC7YYIRXLA146UL68	blanc : : Le blanc est la meilleure couleur car il maintient la température la plus basse à l'intérieur de la niche du chien.  Si le chenil est temporairement placé à l'extérieur au soleil, le chien aura moins de chances de suffoquer, car la température moyenne avec le blanc à l'intérieur du chenil est de _42 degrés Celsius, ce qui est la plus basse de toutes les couleurs. Cependant, si c'est la saison de l'automne ou de l'hiver à l'extérieur, il sera préférable de choisir le noir, car cette couleur réchauffera mieux la niche sous les rayons du soleil à l'extérieur.
es_3CN4LGXD5Z1ZT3FSYPE2UVSJKLX4YO	Blanc : : Le blanc n'absorbe pas la chaleur et n'augmente pas la température du chenil. En été, le chien pourra rester dans le chenil sans avoir chaud.
es_3CPLWGV3MQC6EAHQ8I1IUN5S0XIN9U	gris foncé : : la chaleur qui se concentre à l'intérieur du chenil fait que la couleur qui commence à se répandre à l'intérieur du chenil diminue en intensité, passant du noir à une couleur plus atténuée.
es_3D8YOU6S9GXWRHZ17CASO86KHXHU65	blanc : : La couleur blanche serait la couleur qui ferait baisser la température afin qu'elle indique la moyenne et que le chien soit dans une meilleure situation.
es_3DBQWDE4Y8BNDNFE5SO1I70QG6JN5Z	gris clair : : Je pense que cela donnerait un ton plus léger au chenil.
es_3DBQWDE4Y8BNDNFE5SO1I70QLQW5N3	blanc : : Décrit comment voir la couleur podiatrique affecter l'intérieur de la cassette. USA soleil résultats des expériences pour le rucher aussi description.
es_3DI28L7YXCRKVZ1IB6J6PUT0RKTE18	noir : : Parce que c'est la couleur qui absorbe le plus de température, le thermomètre indique que la température à l'intérieur de la maison est plus élevée que les autres couleurs exposées.
es_3DL65MZB8FS4I2BGR38Q6QCRSS8CE3	gris clair : : Plus la couleur est claire, plus la température intérieure de la maison est basse. J'ai choisi le gris clair, mais j'aurais aussi pu choisir le gris foncé, car n'importe laquelle de ces couleurs serait utile pour les climats froids et chauds. Le blanc dans un climat froid rendrait le bâtiment plus froid, mais dans un climat chaud, il rendrait la température intérieure plus agréable. Le noir rendrait le bâtiment très chaud dans un climat chaud, mais dans un climat froid, il pourrait apporter un peu de chaleur au bâtiment.
es_3DPNQGW4LNSXAJ5MS6JAB48QJFG466	noir : : Il pourrait augmenter la température à l'intérieur du chenil car les couleurs sombres ont tendance à accentuer la chaleur.
es_3DR23U6WE7RL4JDRDP3GV0CVNAUET9	blanc : : Les couleurs claires, contrairement aux couleurs foncées, ont plus de mal à absorber les ondes lumineuses, elles ont donc tendance à avoir plus de mal à retenir cette énergie sous forme de chaleur. La couleur idéale pour la maison du chien est donc le blanc, car c'est la plus claire et la plus adaptée pour les raisons susmentionnées.
es_3DUZQ9U6SO11RUMYJFN0LZ4VDRCVS2	blanc : : La couleur blanche fera que la température de la maison du chien n'augmentera pas autant que dans le cas de l'utilisation d'une peinture de couleur plus foncée. Le blanc serait idéal pour éviter que le chien ne surchauffe et pour qu'il soit confortable à l'intérieur du chenil.
es_3DUZQ9U6SO11RUMYJFN0LZ4VDUNSVG	blanc : : Le blanc serait la couleur la plus appropriée pour peindre le chenil, car c'est la couleur qui permet d'éviter que la température à l'intérieur du chenil ne devienne trop chaude. S
es_3DY4FPOOA31PQFML4QNVVPZZRRARVV	noir : : Dans tous les tests, la couleur noire a été celle qui a connu la plus forte augmentation de température par rapport aux autres couleurs.
es_3DYGAII7PNLC9UAP5ZPWK70C9OZQPE	blanc : : Selon l'expérience, le blanc serait la couleur la plus appropriée pour le chenil, car il maintiendrait une bonne température.
es_3DYGAII7PNLC9UAP5ZPWK70CA03PQ6	gris clair : : Si nous ne connaissons pas les conditions climatiques, nous ne savons pas si nous voulons apporter une température plus ou moins élevée au chenil. Nous devrions avoir une niche blanche en été et une niche noire en hiver. En supposant que nous ne puissions en construire qu'un seul, dans un climat froid en hiver et chaud en été. Mon choix se porterait sur le gris moyen, bien qu'ici j'ai choisi le gris clair par manque d'une autre option. Le gris clair réchaufferait un peu l'abri, mais pas trop.
es_3DYGAII7PNLC9UAP5ZPWK70CG6UQPG	gris clair : : Selon ce tableau, les quatre différents tableaux noir, gris foncé, gris clair blanc Mon choix est le gris clair car il est parfait pour peindre la maison.
es_3E13VNJ1NP8WB4347P9XA9RSFQ9I1G	blanc : : Il est préférable d'utiliser un haut blanc plutôt que les trois autres couleurs, car le blanc n'augmente la température que de _42 degrés Celsius en moyenne.  Les autres couleurs augmentent la température de l'air à l'intérieur du bidon et seraient dangereuses pour votre chien.
es_3E13VNJ1NP8WB4347P9XA9RSIU31I4	blanc : : La lampe produit de la chaleur infrarouge qui est similaire à la chaleur des rayons du soleil. Les surfaces de couleur claire reflètent la chaleur infrarouge par opposition aux surfaces sombres qui l'absorbent. Une caisse sombre deviendrait très chaude dans la journée, une caisse de couleur claire serait beaucoup plus confortable car la température serait plus constante.
es_3E13VNJ1NP8WB4347P9XA9RSJKTI1S	blanc : : Cette couleur pour la peinture de la niche génère le moins de chauffage interne possible de la niche contre une source de chaleur externe (exemple pratique : le soleil).
es_3E1QT0TDFRMEM4NP6AICPJE0TWG8IR	blanc : : étant la couleur la plus claire et après avoir vu les résultats de l'expérience, il est facile de conclure que c'est la bonne couleur pour le chenil, car elle gardera l'air à l'intérieur du chenil plus frais que les autres options.
es_3E1QT0TDFRMEM4NP6AICPJE0YUF8IR	white : : Blanc
es_3E337GFOLBLLTK4YMO7SM4RF4Z8GNN	white : : Selected colour : whiteOn peut conclure, sur la base des résultats de l'expérience, que les couleurs peuvent être affectées par la température : \La couleur blanche a été choisie parce qu'elle indique la température la plus basse et peut apporter du confort au chien en période de chaleur. selon la température que vous souhaitez sur l'échelle du plus froid au plus chaud, les options suivantes sont présentées : option _1 : blanc option 2 : gris clair option 3 : gris foncé option 4 : noir
es_3E337GFOLBLLTK4YMO7SM4RFBWPNGC	blanc : : comme cette couleur les résultats de l'expérience _43 blanc gris clair 44 45
es_3E4GGUZ1TA4U6KBOQWUNS8GA03BK2G	blanc : : La niche du chien sera plus fraîche à l'intérieur lorsque le soleil brille et qu'il fait chaud dehors. La peinture blanche thermique reflétera l'énergie du soleil. Bravo à Brandi et Jerry !
es_3E4GGUZ1TA4U6KBOQWUNS8GA1LBK2H	gris clair : : Parce que c'est une couleur intermédiaire, en été comme en hiver, elle donnera de meilleurs résultats en retenant la chaleur les jours plus frais et en maintenant une température acceptable les jours plus chauds.
es_3E4GGUZ1TA4U6KBOQWUNS8GA28OK25	blanc : : Le blanc est la couleur qui repousse le plus d'énergie et absorbe donc le moins de chaleur. Si nous plaçons un toit blanc, la chaleur sera moins transmise à l'intérieur de la maison et restera à une température plus basse.
es_3E7TUJ2EGEZXSYQDJONFYITYMS1D9L	blanc : : Le blanc est la couleur recommandée car il absorbe moins la chaleur et la maison reste à une température plus basse qu'une autre couleur.
es_3EG49X351WPO8LTWCHLF8F5ODRWX6O	"blanc : : Une hypothèse n'est pas nécessairement correcte. Il s'agit plutôt d'une ""meilleure hypothèse"" et les scientifiques doivent la tester pour voir si elle est effectivement correcte. Les scientifiques testent les hypothèses en faisant des prédictions : si l'hypothèse du texte YYY est correcte, alors le texte YYY devrait être vrai. Ils réalisent ensuite des expériences ou des observations pour voir si les prédictions sont correctes. Si c'est le cas, alors l'hypothèse est confirmée. Si ce n'est pas le cas, il est temps d'émettre de nouvelles hypothèses."
es_3EJJQNKU9TIK8ER1Z16RGO8QRWBRHT	blanc : : la couleur pourrait affecter l'intérieur du hangar
es_3F0BG9B9MR0WCQXB0NC9X7CT9WEY79	blanc : : Le blanc est la couleur qui absorbe le moins d'énergie en raison de sa composition, puisqu'il est composé de toutes les couleurs. Pour la niche de Brandi et Jerry, la couleur idéale est le banc, car c'est celle qui a eu la température la plus basse et la variation entre les tests a été de _1 à 2 degrés. Avec ce résultat, nous pouvons affirmer que le blanc a la température la plus basse et que la variation de la température moyenne est minimale.
es_3F6KKYWMNDEIH0U7KY6KGJOITMYNDM	blanc : : La couleur blanche aiderait le chien à l'intérieur du chenil à rester dans un endroit à température contrôlée plus proche de la température à l'extérieur du chenil.
es_3FE7TXL1LK0GHN9J31EKOUSJY8Z2QJ	blanc : : D'après les résultats de l'expérience, la meilleure couleur pour la niche du chien est le blanc. Le blanc est la couleur qui absorbe le moins la température, ce serait donc la couleur idéale pour le chien de Brandi et Jerry.
es_3FFJ6VRIL31W4FIMB65XW48IAXV0IL	gris clair : : La couleur gris clair permettrait d'augmenter un peu la température et le chien n'aurait pas si froid. L'utilisation d'une couleur plus sombre serait préjudiciable car le chien aurait trop chaud et voudrait sortir de la maison.
es_3FQ5JJ512N1QV60HCFS7KWJ8ATLNKI	blanc : : La température de l'air avec la couleur blanche était la plus basse avec _42 C. Le chenil doit être blanc pour que le chien ne souffre pas des températures élevées. Plus la peinture est foncée, plus c'est mauvais pour le chien.
es_3FQ5JJ512N1QV60HCFS7KWJ8AVMNKN	blanc : : Je choisirais le blanc parce que la température augmente plus lentement que les couleurs plus foncées. C'est important car le chien a également besoin de températures plus basses avec toute la fourrure qu'il possède. D'après l'expérience, le blanc s'avère avoir une température plus basse.
es_3FTF2T8WLTVW14Q40JS5Q6IJSETW9A	blanc : : blanc se réveille plus que les autres.
es_3FTF2T8WLTVW14Q40JS5Q6IJUDA9W4	blanc : : Le blanc étant la couleur qui absorbe le moins d'énergie, l'intérieur du chenil ne chauffera pas autant qu'avec les autres couleurs.
es_3FTF2T8WLTVW14Q40JS5Q6IJXRLW9X	blanc : : La couleur blanche, en réfléchissant les rayons du soleil, fera baisser la température de la maison par rapport à toute autre couleur de peinture. Les résultats de l'expérience confirment cette hypothèse, car ils indiquent que les températures à l'intérieur du bocal en verre sont plus basses lorsque le couvercle blanc est utilisé.
es_3FTYUGLFSWYERBO1GYAYM2OW01L5DZ	noir : : Selon les résultats de l'expérience, un bidon noir sera plus chaud qu'un bidon blanc car les couleurs sombres absorbent plus d'énergie et augmentent la température à l'intérieur du bidon.
es_3G0WWMR1UXXC69YCPKC4GIVHB7RQN9	gris clair : : La couleur gris clair serait le meilleur choix, selon le tableau des résultats, elle se situe au milieu des extrêmes, ce qui rendrait les variations de température extérieure dues aux changements saisonniers moins extrêmes.
es_3GDTJDAPVWO0INDGRPG4HCLHALQM87	gris clair : : Blanc
es_3GDTJDAPVWO0INDGRPG4HCLHI4R8M4	gris foncé : : GEIS DARK GEIS
es_3H0W84IWBMF8O40Z90YLVLBDRWXREF	gris foncé : : Une donnée importante pour cette expérience est le climat de la zone où la cabane est installée, je pense que je pourrais choisir le gris foncé parce que la température est plus stable et la couleur noire par exemple s'il fait trop chaud en été ce serait trop inconfortable pour se reposer.
es_3H7XDTSHKE4BGEDCEPYFIN461XDGWR	blanc : : La couleur a un effet sur la température que le chenil aura à l'intérieur. D'après les données fournies, la couleur qui consomme le moins d'énergie est le blanc par rapport au noir.
es_3H7Z272LX9K1IXUCDUH03L1I31ILPW	gris clair : : Je considère qu'il s'agit d'un point intermédiaire car il y a d'autres facteurs qui ne sont pas pris en compte comme l'emplacement du bâtiment (extérieur ou non), si c'est un climat habituellement humide ou chaud, etc...
es_3H7Z272LX9K1IXUCDUH03L1IZ8IPLA	blanc : : Le blanc est la couleur qui fera le moins monter la température à l'intérieur de la maison lors des journées chaudes (_18°C au-dessus de la température initiale, contre près de 30°C avec le noir). En hiver, n'importe laquelle des autres couleurs utilisées dans l'expérience contribuerait à réchauffer la température à l'intérieur du chenil, mais compte tenu des caractéristiques des chiens et de leur pelage, il est plus pratique de donner la priorité au fait de ne pas trop augmenter la température en été.
es_3HFNH7HEMJR6WHHQ2GZ9QYMKCO7QGR	noir : : le noir est la meilleure couleur pour affecter l'intérieur du chenil car le noir est la couleur qui attire le mieux la chaleur de l'air. C'est pourquoi le chien pourrait être mieux loti. Les données le prouvent car le chenil noir parvient à avoir une température de _54 degrés, plus ou moins.
es_3HHRAGRYXAIOWVH29X1V9C5XSIG9OC	blanc : : D'après les résultats, le blanc est la couleur qui absorbe le moins la chaleur des rayons du soleil. La température à l'intérieur de la niche ne sera donc pas aussi élevée que si elle était peinte avec d'autres couleurs.
es_3HMIGG0U4NJ0C42UAS4FB78OKHJ8Y7	blanc : : Si ce que vous voulez est un chenil avec une température plus basse (surtout pour l'été), la couleur devrait être blanche, car elle n'absorbe pas la chaleur comme le feraient des couleurs plus foncées.
es_3HMVI3QICL5I14I9B7V0WXLGCN51Y2	gris foncé : : Le gris foncé est la couleur moyenne qui réagirait le mieux comme une vraie bonne option pour faire la maison, la température serait en bon état, la maison serait belle et elle représenterait une maison vraiment merveilleuse à vivre.
es_3HOSI13XH119VO3UV4SHKECOH91DDJ	blanc : : SELON CE TABLEAU BRANDI ET JERRY CHOISISSENT LES QUATRE COULEURS DE CHOIX, L'UNE D'ELLES EST NOIRE, GRIS FONCÉ, GRIS CLAIR, BALNCO. JE PENSE QUE LA COULEUR BLANCHE EST PARFAITE PARCE QUE LE TEST _1 ET LE TEST 2 SONT UN MÉLANGE DE 42 ET 43 ET LE TEST 3 ET DEMI EST 41 ET 42 DONC CHAQUE COMBINAISON EST TRÈS BONNE ET LE BLANC EST PARFAIT POUR LE CHIEN.
es_3HPZF4IVNO62O7S7R4KKDT47B3PCYT	noir : : Selon les résultats de l'expérience, le noir est la couleur qui augmenterait le plus la température du chenil. En effet, le noir absorbe la lumière au lieu de la réfléchir, et reçoit donc plus d'énergie de la lumière. Cette couleur serait idéale pour les maisons destinées aux zones froides.
es_3HPZF4IVNO62O7S7R4KKDT47C7AYC9	gris clair : : la température en gris foncé ne change pas du tout.
es_3HRMW88U183I0Y8DWL3POXFZUY30MC	white : : Le blanc est la couleur dont la température est la plus basse dans tous les tests. Pour une niche de chien, ce serait la meilleure couleur pour empêcher le chien d'avoir chaud.
es_3HVVDCPGTG5JAOUIDQFA234BXTCYTR	noir : : Le noir permet au chien d'avoir un foyer plus chaleureux.
es_3HYA4D452TWJQYJAPL3QCVO5R3T2FM	gris clair : : gris clair
es_3HYA4D452TWJQYJAPL3QCVO5R4EF2M	blanc : : La meilleure couleur est le blanc car il garde l'air à l'intérieur du chenil plus frais. Il ressort des résultats de l'expérience que le couvercle blanc a maintenu la température du chenil plus basse que les autres couvercles.
es_3I2PTA7R3V7BY3D9S7KOOQEDFBUKQ2	gris clair : : pourrait avoir un impact sur l'intérieur en lui donnant un aspect plus vivant, moderne et attrayant.
es_3I33IC7ZWHFOU722E5HYYUDEZK3A23	blanc : : L'INTÉRIEUR DE LA CHAMBRE SERA PLUS FROID. COMME VOUS POUVEZ LE VOIR DANS LES RÉSULTATS, LA TEMPÉRATURE DE L'AIR À L'INTÉRIEUR DE LA BOÎTE EN VERRE AVEC LE COUVERCLE BLANC ÉTAIT DE _42, 43, 41 ET 42. DANS LES QUATRE TESTS, C'ÉTAIT LE RÉSULTAT LE PLUS BAS. C'EST BON. ET CELA SIGNIFIE QUE LA COULEUR BLANCHE EST LA COULEUR LA PLUS FRAÎCHE.
es_3I3WADAZ9SH5V8FQ67OEXW0V8YN5OX	blanc : : parce que la peinture blanche chauffe moins et que la température est plus basse.
es_3IGI0VL649X9LXLWA7K0RD0HUZ1NOA	noir : : La lumière n'est rien d'autre qu'un rayonnement électromagnétique et, en tant que tel, elle transporte de l'énergie. Les couleurs claires, comme le blanc, sont celles qui réfléchissent le plus de rayonnement, et donc absorbent très peu ou rayonnent très rapidement l'énergie qu'elles absorbent. Les couleurs sombres, comme le noir ou le gris foncé, absorbent le plus de rayonnement. Ils sont capables d'absorber une grande quantité d'énergie de ce type, puis de la diffuser lentement. Ainsi, si nous utilisons des couleurs sombres pour la niche de notre chien, elles absorberont le rayonnement solaire pendant la journée et fourniront à notre chien de la chaleur pendant une période plus longue pendant la nuit. Plus le couvercle est foncé, plus la température à l'intérieur du chenil sera élevée lorsque la lumière sera éteinte, comme le montrent les résultats du tableau, et il en sera de même lorsque le rayonnement solaire s'épuisera le soir. La température sera plus élevée et la chaleur sera maintenue à l'intérieur de la maison pendant une plus longue période.
es_3IHR8NYAM9E5KPNR72IJH4Z7FB9P4J	noir : : La couleur noire affectera le bâtiment en rendant la lumière plus froide.
es_3II4UPYCOLK3KX7Z0QY1KDJNWT8QDP	gris clair : : La différence de température entre le blanc et le gris clair est très faible et le chien appréciera davantage la couleur grise car il ne voit pas en noir et blanc.
es_3IJXV6UZ1ZWK492L5JOCG095LP1IRE	blanc : : La couleur blanche garantit une température plus basse à l'intérieur de la niche du chien, selon les résultats des expériences. Les couleurs grises entraîneraient une légère augmentation et le noir la température la plus élevée.
es_3IOEN3P9S9WGIK835O08D61N9XV16L	noir : : Parce que plus la couleur est foncée, plus l'absorption d'énergie augmente et donc le résultat est noir.
es_3IQ1VMJRYVXZURN1ZEWD8HLS1139A2	blanc : : D'après les résultats, la couleur blanche est celle dont la température n'augmente pas autant que celle des autres couleurs.
es_3IRIK4HM3CX05NI1LLPSU2KEFFEC6M	blanc : : le blanc est la couleur dont la température est la plus basse dans l'une des études par rapport aux autres couleurs des expériences.
es_3IXQG4FA2VB4D1ST5SW93S5YIBZ9BR	blanc : : C'est la couleur la plus adaptée, car elle ne donnera pas trop chaud au chien, le blanc n'élevant pas la température autant que le noir ou les couleurs plus foncées. Bien entendu, la température extérieure doit également être prise en compte. Dans les endroits très froids, il est préférable d'utiliser le noir, et dans les endroits chauds, le blanc. Salutations.
es_3J88R45B2IBWIRB1RDKOEFW56MRPX5	noir : : si vous faites une maison avec un toit noir, la maison sera plus chaude, car le toit absorbe plus de chaleur.
es_3J88R45B2IBWIRB1RDKOEFW57N7PXO	blanc : : Selon l'expérience, le blanc est la couleur qui diffuse le moins la chaleur. Une autre couleur serait trop chaude pour le chien
es_3JBT3HLQFAFLNMBGSV89B0CGEKSZPB	gris foncé : : Cette couleur a donné lieu à _48 à chaque fois, ce qui permet de contrôler la température du chenil afin qu'elle ne varie pas.
es_3JJVG1YBEDALCEQH22JSRC0WWFPB5B	blanc : : Plus la couleur est foncée, plus elle absorbe d'énergie et plus elle génère de chaleur. Le blanc serait donc le meilleur choix.
es_3JPSL1DZ5UCKJTRV0OFIQIGC6JTNAA	blanc : : plus la couleur du bâtiment est claire, moins la température de l'air à l'intérieur du bâtiment augmentera, car les couleurs claires absorbent moins d'énergie.
es_3JV9LGBJWVR3B54AN3751TRKXB9OGD	blanc : : la couleur blanche permet de maintenir une température basse dans la niche du chien, car la chaleur corporelle du chien nécessite un endroit frais et la niche du chien est fermée, le blanc permet de maintenir une température basse et le chien n'aura pas trop chaud.
es_3JWH6J9I9UQP23WN62FELT0IP4SBNE	blanc : : L'utilisation du blanc entraînera une température plus basse par rapport aux autres couleurs et sera plus confortable pour le chien.
es_3K4J6M3CXG6E91A9DK2N0Y7F47OAG5	blanc : : En regardant les résultats obtenus dans l'expérience, vous pourriez supposer que les faits démontrés dans l'expérience s'appliquent également à la niche du chien. Ainsi, si la niche est peinte d'une couleur sombre, la température à l'intérieur du chenil augmentera comme dans l'expérience, mais si une couleur plus claire est utilisée, par exemple le blanc, la température de l'air à l'intérieur du chenil pourrait être réduite.
es_3KGTPGBS6ZY89GG0KAYPYVP81W8U2P	blanc : : Le blanc, car c'est la couleur qui attire le moins la chaleur, car plus la couleur est foncée, plus elle absorbe la chaleur.
es_3KJYX6QCMBO8SR38WLEMTYD8HF1VJ2	blanc : : le blanc étant une couleur claire, il n'absorbe pas autant d'énergie. Selon le tableau de données, le blanc a les températures les plus basses et est donc la couleur la plus favorable.
es_3KMS4QQVK43E7EN0ER9UCRAZ92TFKY	"noir : : Le couvercle est noir, la couleur sera donc plus élevée. La section ""Données"" indique la relation entre la température et la couleur."
es_3KRVW3HTZPYI17SP5NM9Y3LIM4CSM6	blanc : : Le blanc étant la couleur la plus claire, il absorbera moins d'énergie et il y aura moins de chaleur dans le bâtiment.
es_3KWTYT0872GXPNCTTF8M5FW1FHM5LY	gris foncé : : gris foncé
es_3L0KT67Y8GTIVOH3OQAKSY8PVBKSYK	blanc : : Le blanc est la couleur qui isole le mieux la concentration de chaleur, ce qui est optimal pour les journées et/ou les nuits chaudes. En cas d'hiver, vous pouvez choisir une option autre que la peinture pour servir d'isolation et de protection contre le froid.
es_3L0KT67Y8GTIVOH3OQAKSY8PZV2YSG	blanc : : Parce que la couleur blanche apporte de l'énergie et donne aussi une forme esthétique à la maison.
es_3L2IS5HSFCV4Y25T6TW9QJS6DT8NUN	white : : Choisir le blanc permet de stabiliser la température.
es_3LEIZ60CDLC0VZV9B6CCPAC19DIZ9I	blanc : : D'après les données de l'expérience de Brandi et Jerry, le couvercle blanc est celui qui a le moins augmenté la température à l'intérieur du récipient. Ainsi, un toit (et des murs) blancs pour une niche blanche serait le plus approprié pour le confort de l'animal. Cependant, l'approche ne dit pas dans quelles conditions le chenil sera utilisé. Peut-être que dans une région où les températures sont basses (l'Alaska par exemple), un chenil avec un toit sombre pourrait aider à maintenir une température plus appropriée pour l'animal.
es_3LJ7UR74RJQ5H4BERN5RDFUCFN4N4Z	noir : : le noir serait mieux
es_3LO69W1SU5QV5K1DABRD9CNQ3DELGI	blanc : : Le résultat de l'expérience montre que plus la couleur de la surface est foncée, plus l'intérieur est chaud, alors que l'objet reçoit de la lumière. J'ai choisi de peindre les niches en blanc pour que l'intérieur ne soit pas trop chaud pour mon chien.
es_3LRKMWOKB7UPVFAAQ\nFN4N5I92ZI	blanc : : Le blanc repousse la lumière du soleil et donc la chaleur.
es_3LRKMWOKB7UPVFAAQ\nFN4N7SB2Z6	noir : : Les tests effectués lors de l'expérience confirment l'hypothèse de Brandi et Jerri : la température du chenil était d'autant plus élevée que la couleur du couvercle placé à côté de la source de chaleur était foncée. Ainsi, la couleur noire, étant la plus foncée, absorbe le plus d'énergie et est la mieux adaptée pour conserver la chaleur reçue par la niche du chien, par exemple, par le rayonnement solaire.
es_3LRLIPTPESMJBN6S3BN2YQZ8BVQKAH	blanc : : Le blanc est la meilleure couleur car il permet à la chaleur d'être réfléchie par la source et seule une petite quantité de chaleur est transmise à l'intérieur. Les résultats de l'expérience montrent que la couleur blanche a la température la plus basse à l'intérieur de la boîte et rend le chien confortable par rapport aux autres couleurs.
es_3LUY3GC631D23C5A90GQKGJH4R47PG	gris foncé : : La peinture gris foncé permet de maintenir une température constante.
es_3LWJHTCVCEZ0IHLVRWTR8DM8FWYFQM	gris foncé : : La température n'est ni trop chaude ni trop froide avec la couleur gris foncé.
es_3M68NM076JK4BP7K3IFNJXJ0AVAR6P	blanc : : Le blanc donnera moins de chaleur au chenil car c'est la couleur qui absorbe le moins l'énergie thermique.
es_3M68NM076JK4BP7K3IFNJXJ0AVM6RG	blanc : : LA COULEUR BLANCHE REFROIDIT LA LUMIÈRE ET PERMET DE MOINS CHAUFFER. TANDIS QUE PLUS LA COULEUR EST FONCÉE, PLUS ELLE ATTIRE LA LUMIÈRE ET PLUS ELLE CONCENTRE LA CHALEUR.
es_3M81GAB8A2WA509FMU7VPNVNUKCQBN	blanc : : La couleur blanche serait plus réfléchissante et bloquerait donc une partie de la lumière du soleil pendant la journée, ce qui permettrait de faire baisser la température à l'intérieur du bâtiment.
es_3MHW492WW2QYTZ9TZIRE9Q5PL47MVY	blanc : : Plus la couleur est claire, plus la température est basse et plus le chien sera à l'aise.
es_3MMN5BL1W1HEHQ7AF8L8QVD615V3MC	blanc : : En choisissant le blanc, la niche du chien ne devrait pas être si chaude.
es_3MMN5BL1W1HEHQ7AF8L8QVD6USO3M8	gris clair : : Le gris clair est la meilleure couleur pour le chenil car la température n'est ni trop basse ni trop élevée et cela peut aider le chien à s'adapter aux différentes températures extérieures.
es_3MMN5BL1W1HEHQ7AF8L8QVD6WO1M3Y	gris foncé : : Pas question, car cela n'interfère pas avec la température à l'intérieur du chenil pour le chien.
es_3MTMREQS4XVA6N09SP65M1T3Z4CWA7	black : : Le noir est plus chaud selon les résultats.
es_3MX2NQ3YCB7SPHTI7YBAG9ROF0TX5M	blanc : : Je choisirais le blanc, pour que le chien n'ait pas trop chaud. Le blanc est la couleur qui augmente le moins la température, elle peut même isoler le chien, ce serait donc un bon choix de choisir la couleur mentionnée ci-dessus.
es_3N1FSUEFL7DWVSK12TROHAIIZA64DI	blanc : : D'après les résultats de l'expérience, la température à l'intérieur du bidon était maintenue à une température plus basse lorsque le couvercle blanc était utilisé. Ils ont donc démontré que les couleurs sombres retiennent effectivement plus de chaleur et les couleurs claires moins. En utilisant du blanc pour la niche du chien, la température interne sera plus fraîche qu'en utilisant une couleur plus foncée.
es_3N8OEVH1FT3R3IL8BMKD620MRHUOO1	blanc : : doux
es_3NG53N1RLXW63QATJ58WYGFCGJH8PS	noir : : le noir a la température la plus élevée dans les résultats de l'expérience.
es_3NG53N1RLXW63QATJ58WYGFCGMM8P3	blanc : : Les couleurs sombres absorbent plus de lumière et seront plus chaudes pour le chien.
es_3NKQQ8O390IVCQEGHZI6UEGCYKMDU0	blanc : : Le chenil restera plus frais car le blanc est la couleur qui élève le moins la température à l'intérieur du récipient en verre. S'ils utilisent du blanc, la niche du chien sera beaucoup plus fraîche lorsqu'ils allumeront la lampe (s'ils ont une lampe à l'intérieur de la maison) ou simplement à la lumière du soleil. Comme le montrent les résultats, les deux couleurs présentant la plus faible variation de température sont le gris clair et le blanc. La différence entre le blanc et le gris clair n'est que de quelques degrés Celsius, mais pour une efficacité et une utilisation maximale de la basse température, il serait préférable d'utiliser le blanc. \Mais il serait également idéal d'utiliser le noir dans le cas où le chien se trouve dans un environnement très froid où les températures baissent généralement la nuit ou même le jour, la couleur noire l'aiderait à conserver la chaleur d'une ampoule à l'intérieur de la maison.
es_3NKQQ8O390IVCQEGHZI6UEGCZ25UD1	noir : : _1/ mettre la lampe noire avec le filtre accroché, au bol en verre 3/ s'assurer que la température initiale à l'intérieur du bol est de 24 c ; 3/ mettre la lampe à quelques centimètres du couvercle et l'allumer 4/ après 10 min, mesurer la température de l'air à l'intérieur du bol en verre ; mettre le test
es_3NKQQ8O390IVCQEGHZI6UEGCZ27UD3	blanc : : Plus la couleur de la maison est claire, plus la différence de température atteinte à l'intérieur de la maison est faible.
es_3NPI0JQDAQIP1A2HM3JRPCBZTRGPT1	gris clair : : Le gris clair est une bonne couleur, car il ne rend pas la maison trop chaude ou trop froide. Cependant, cette expérience n'est qu'une indication de ce à quoi il pourrait ressembler dans un chenil, car il ne va pas rester sous une lampe pendant _10 minutes. Pourtant, une couleur intermédiaire serait la plus appropriée à mon avis.
es_3NPI0JQDAQIP1A2HM3JRPCBZX90PTP	blanc : : La peinture blanche doit être utilisée pour abaisser la température et maintenir un environnement frais à l'intérieur du chenil, car selon l'expérience, la couleur blanche rend l'intérieur du chenil moins chaud que si des couleurs sombres étaient utilisées.
es_3NQL1CS15TLYNGY7ILFP3LSW208VY0	noir : : Le haut noir donne des températures plus élevées pendant toutes les expériences. La couleur noire masque davantage la chaleur.
es_3NVC2EB65SCEB7WOYB9JKQ0D3XC3YY	blanc : : La meilleure couleur est le blanc qui retient moins la chaleur. De cette façon, le chien des deux enfants ne mourra pas de chaleur.
es_3O7L7BFSHG2VV5XGJD4CHTAM70SEIF	gris clair : : grise claro
es_3OE22WJIGK1P1ZILMLOQUDNBM53UQV	gris clair : : La température initiale était de _24 c dans tous les essais.
es_3OF2M9AATI1KCVE0F331FJQHMHBZKF	blanc : : La maison serait plus fraîche avec du blanc.
es_3OF2M9AATI1KCVE0F331FJQHR6QKZY	blanc : : La couleur blanche absorbe le moins d'énergie, et la température de l'air à l'intérieur de la maison sera donc la plus basse. Les résultats du test prouvent l'hypothèse.
es_3OHYZ19UGEI21ER713FV57GHWVJOAF	blanc : : Peindre la maison en blanc la rendra plus fraîche, car les couleurs claires retiennent moins la chaleur.
es_3OLF68YTNBE8V1EE20W5ID73AQ8FAY	noir : : parce que cette couleur avait des scores plus élevés.
es_3OLQQLKKNU2RQGHM1VPCTUPMNS3EJ6	gris clair : : Le blanc reflète l'énergie radiante alors que les couleurs sombres comme le gris ou le noir l'absorbent. Plus le plafond est chaud, plus il fera chaud à l'intérieur de la maison. J'ai donc choisi le gris clair pour que l'intérieur de la maison ne soit ni trop froid ni trop chaud.
es_3OS4RQUCRBSDEBJ68EW1DOR9Q3VBFF	blanc : : Beaucoup moins de chaleur
es_3OSWBBLG1GANTU8BM4TTELFGTX0XD0	blanc : : En utilisant les résultats de l'expérience, j'ai déterminé que le blanc serait la meilleure option. Par rapport aux autres couleurs, le blanc est la couleur qui absorbe le moins de chaleur.
es_3OVR4I9USRWQK1O67FX8H9PHMC44QA	blanc : : Je choisis le blanc parce que les données des trois tests montrent que la maison serait à une température plus fraîche que celle que ma famille préfère. Nous vivons au Texas, où la plupart des jours sont chauds.
es_3OWEPKL08BP20RTXTL3YGREM4BB7NQ	blanc : : Le blanc serait la couleur idéale, car plus il est clair, plus il fera frais à l'intérieur de la maison du chien, car les couleurs claires absorbent moins d'énergie, c'est-à-dire qu'elles gardent la pièce plus fraîche.
es_3OWEPKL08BP20RTXTL3YGREM4LIN7X	blanc : : sur la base du tableau, je trouve que la couleur blanche donnera une température ambiante plus basse, donc le chien de brandi et jerry sera plus confortable et plus frais, l'autre option pourrait être le gris clair car la différence entre les températures n'est pas trop grande, le noir n'est définitivement pas une option car l'augmentation de température est trop élevée.
es_3OXV7EAXLG3CSNMISSER1ZGK4IQ36V	blanc : : Lorsqu'ils peignent le chenil de leur chien, ils se soucient des effets de la couleur sur la température intérieure.  Un chien souffrira beaucoup (et peut être mourra) dans un environnement trop chaud, et un chenil qui n'absorbe pas autant de chaleur est nécessaire.  D'après l'expérience, nous pouvons constater que les couvercles plus foncés retiennent plus de chaleur (d'après tous les tests), et que le couvercle blanc en retient moins.  Par conséquent, nous pouvons voir que le blanc est la meilleure couleur si nous recherchons une peinture qui sera plus fraîche après un long moment au soleil.  Et une température moins chaude sera meilleure pour le chien.
es_3P59JYT76NXT931BK58FTZ36NL62TM	blanc : : le blanc serait bon, car si la température de la pièce est de _24 degrés, cela signifie que la température est déjà confortable et qu'il n'est pas nécessaire de la chauffer davantage, donc le blanc maintiendrait une bonne température pour le chien.
es_3PDJHANYK7TRMVTH7D3T5THUNM96H4	blanc : : La couleur noire absorbe beaucoup de chaleur, ne laissant pas la lumière et la chaleur s'échapper, c'est pourquoi la température à l'intérieur du chenil augmenterait dans le cas du noir. C'est pourquoi j'ai choisi le blanc pour donner plus de fraîcheur au chenil.
es_3PDJHANYK7TRMVTH7D3T5THUSW1H6W	blanc : : la couleur blanche reflète la lumière et la température est donc plus basse.
es_3PEIJLRY6V6M20823ZYJ6941298WX4	noir : : Je crois que le noir maintient la température plus longtemps.
es_3PEIJLRY6V6M20823ZYJ69412R5WX1	blanc : : Selon l'expérience, le blanc est la couleur qui augmente le moins la température du lieu, dans ce cas, le chenil. Le chien se sentira plus à l'aise dans un environnement plus frais, mais le chenil aura besoin d'une ventilation supplémentaire.
es_3PEIJLRY6V6M20823ZYJ6941ZPWXWM	blanc : : L'expérience a montré que la couleur blanche rend l'air à l'intérieur du chenil moins chaud, on pourrait donc penser qu'un toit blanc contribuerait à rendre le chenil plus frais pour le chien.
es_3PIWWX1FJLJZ1W3EFW03QA2ERNMJJS	blanc : : Cela le gardera aussi frais que possible.
es_3PJ71Z61R6F303A13V3KXGSPW0Q19K	blanc : : La lampe ne peut atteindre qu'une certaine température.
es_3PJ71Z61R6F303A13V3KXGSPZAJ190	blanc : : Avec cette couleur, la niche absorbera moins d'énergie, en fonction des résultats de l'exercice, de sorte que la température de l'air à l'intérieur de la niche sera aussi basse que possible, ce qui la rendra plus confortable pour le chien.
es_3PWWM24LHUBABJ9NH7XK237J58X82B	blanc : : pour un meilleur confort thermique de votre chien, vous devez utiliser la housse blanche.
es_3PZDLQMM0VYCNMZ0YJDP4P32U3R2CR	blanc : : C'est la couleur qui permet de garder le chenil plus frais.
es_3Q5C1WP23OEKZG8P05Q3L0NNA4J155	blanc : : La couleur blanche absorbe le moins d'énergie, par conséquent, la température à l'intérieur du chenil sera plus basse par rapport à une couleur plus foncée. Ce même raisonnement est soutenu par l'expérience des couvercles de couleurs différentes.
es_3QEMNNSB2ZCTEF2K4RPVKM2SR19D73	gris clair : : Plus la couleur de l'extérieur est foncée, plus elle absorbe d'énergie, le blanc étant la couleur qui absorbe le moins d'énergie et le noir le plus. Par conséquent, en été, une couleur noire ferait augmenter considérablement la température intérieure, tandis qu'une couleur blanche rendrait la température intérieure plus agréable. En hiver, ce serait l'inverse, une couleur sombre serait plus intéressante, alors peut-être qu'une couleur intermédiaire serait idéale.
es_3QIYRE09Y5UOP5EV45MPFHN91OS1N2	blanc : : Selon les données, les couleurs sombres absorbent plus d'énergie. Par conséquent, une couleur plus claire conviendrait mieux, car elle présente des températures plus basses.
es_3QJOXOW4XL4HRON74S249MH3M8HEMW	blanc : : Si le climat où le chien va vivre est chaud, la meilleure couleur est le blanc pour garder l'intérieur plus frais.
es_3QJOXOW4XL4HRON74S249MH3M9UEMB	blanc : : Le blanc est la couleur pour laquelle la température moyenne de l'air à l'intérieur du bocal est la plus basse. Le blanc est la couleur qui absorbe le moins d'énergie et qui affecte donc le moins l'intérieur du chenil.
es_3QUO65DNQW1MGN5578WM58SB3YYUOK	Blanc : : En peignant la maison en blanc, Brandi et Jerry s'assurent que la chaleur à l'intérieur de la maison est moins élevée que s'ils la peignaient d'une autre couleur. En effet, leur hypothèse s'est avérée correcte après des expériences avec d'autres couleurs.
es_3QXNC7EIPK83TEPJ7CZKJB9FRLR90M	blanc : : La couleur blanche est choisie pour que le chenil ne chauffe pas autant à l'intérieur et que le chien soit plus à l'aise, comme on peut le voir dans les données du tableau expérimental, en choisissant une couleur plus claire, l'intérieur chauffera moins. On sait également que les couleurs noires ou opaques (comme le gris clair ou le gris foncé) ont tendance à absorber davantage de rayonnement.
es_3QY7M81QH9Z1SL8UW8BIOZXID5P7KL	gris clair : : dans la journée, le chien pourra bien se tenir debout et voir la lumière. Ainsi, la nuit, le chien aura la paix et le calme pour dormir.
es_3QY7M81QH9Z1SL8UW8BIOZXIDGNK7I	blanc : : Si la température du chenil est la même que dans l'expérience, je choisis le blanc car _53, 48 et 45 degrés, c'est trop pour un animal.
es_3R08VXYT7E8SNL2BLMULCARDYL0W7O	blanc : : Peindre le chenil en blanc permet d'éviter qu'il fasse chaud à l'intérieur lors d'une journée ensoleillée, car le blanc reflète davantage l'énergie du soleil qu'une couleur plus foncée. Le test avec les couvercles de différentes couleurs montre que, parmi les quatre couleurs, c'est le blanc qui fait le moins monter la température à l'intérieur du bocal.
es_3R0T90IZ1UP22G77XYYE6TX3CZDGC3	blanc : : Blanc car la maison est plus fraîche en été et plus chaude en hiver.
es_3R3YRB5GRHGXEJB4XPR44D86DF1UAN	blanc : : Le blanc serait la meilleure couleur pour la peinture du chenil, car il absorbe le moins d'énergie du soleil, de sorte que le chien a un chenil qui n'est pas trop chaud. L'expérience montre clairement que les couleurs sombres absorbent plus d'énergie et plus de chaleur.
es_3R3YRB5GRHGXEJB4XPR44D86H7GUAQ	blanc : : La couleur blanche empêcherait le chenil de devenir trop chaud en plein soleil, surtout en été.
es_3R6BYFZZP9PKREM7DAOJ2LI16Z8XFI	blanc : : Tout dépend de la température souhaitée, si vous vivez dans un endroit chaud, il est préférable d'utiliser du blanc pour garder la niche plus fraîche. Si vous vivez dans un endroit froid, le noir serait idéal pour garder le chenil plus chaud.
es_3R6BYFZZP9PKREM7DAOJ2LI1BUQXFV	blanc : : Le blanc serait la couleur idéale car ainsi, lorsque le soleil frappe le chenil, il ne fait pas trop chaud à l'intérieur lorsque les chiens y sont.
es_3RANCT1ZVHU2XTGW33R0ZOSCVWEUB8	blanc : : Quelle que soit leur couleur, la plupart des surfaces solides qui sont soumises à une source de chaleur rayonnante absorbent la chaleur et la transmettent à leur environnement, augmentant ainsi leur température. Mais en fonction de leur couleur, ces surfaces absorberont un degré différent de chaleur. L'expérience a montré que les surfaces aux couleurs plus foncées absorbent plus de chaleur en _10 minutes que les surfaces aux couleurs plus claires. Par conséquent, si Brandi et Jerry choisissent une couleur plus claire pour la peinture de leur niche, une plus grande quantité de rayonnement solaire sera réfléchie par le toit et les murs, qui chaufferont moins et transmettront moins de chaleur dans la niche du chien. C'est important parce que la lumière du soleil tombe sur la maison, pas seulement pendant 10 minutes, mais pendant de nombreuses heures par jour, parfois jusqu'à 15 heures. Mais il y a une différence : l'expérience a été réalisée avec un récepteur de chaleur étanche (fermé en haut par un couvercle et sur les côtés et le fond par du verre). D'un autre côté, la niche pour chien comporte un trou par lequel le chien entre et sort, ce qui permet à l'air d'entrer et de sortir, rendant l'intérieur de la niche plus frais.  Une petite fenêtre peut être pratiquée dans le mur opposé à l'entrée de la niche du chien, de sorte que l'air circule efficacement dans la maison et la refroidisse davantage.
es_3RJSC4XJ127KSRN74MM37V4DA7F05Y	blanc : : La couleur blanche du chenil signifie que l'intérieur du chenil n'est pas trop chaud, de sorte que le chien n'aura pas trop chaud en été.
es_3RKNTXVS3OBYXLHPIJ0MR9ACGP44AD	blanc : : Brandi et Jerry devraient utiliser la couleur blanche plus claire pour la niche de leur chien, car ainsi le chien n'aura pas trop chaud.  Les températures pour le blanc étaient inférieures à celles du gris clair, du gris foncé ou du noir.  Ce serait donc probablement une bonne couleur pour le toit.
es_3RRCEFRB7OP3GVMHOX0IMKUI0IA4BH	blanc : : J'ai choisi le blanc car plus la couleur de la housse est foncée, plus la température de l'air augmente et cela serait gênant pour votre chien. Sans aucun doute, le blanc est le meilleur choix pour le chien, car la température monte moins.
es_3RRCEFRB7OP3GVMHOX0IMKUIWKVB49	blanc : : Si l'on utilise une couleur sombre pour le chenil, l'air à l'intérieur pourrait devenir trop chaud et être désagréable pour le chien, par conséquent, la couleur choisie est le blanc afin que lorsque la lumière du soleil le frappe, il se réchauffe le moins possible sans atteindre une température dangereuse. Selon le tableau, le blanc pourrait chauffer jusqu'à _43º, tandis que le noir par exemple 54º.....
es_3RSDURM96CZHL5CLNVQF3H4AVIPYE0	gris foncé : : Je pense que cette couleur est parfaite car le noir est très chaud et le blanc n'est pas la bonne couleur pour un animal car il se salit très vite.
es_3RU7GD8VPQ6OMAP2X3E1F7FDR2ZSP0	blanc : : La couleur devrait être blanche, car elle n'absorbe pas autant de rayonnement et empêcherait la température d'augmenter et d'étouffer l'animal pendant la journée à cause de la lumière du soleil.
es_3RU7GD8VPQ6OMAP2X3E1F7FDRD6PSQ	blanc : : Pour le froid, je peux utiliser des couvertures, mais le pire problème serait la chaleur en été, donc si je le fais blanc, il chauffera moins.
es_3RU7GD8VPQ6OMAP2X3E1F7FDSP4SPG	blanc : : Nous choisirons le blanc pour la niche du chien, afin qu'elle reste plus fraîche à la lumière du soleil. Des tests ont montré que la couverture blanche absorbe moins de chaleur que toute autre couleur.
es_3RU7GD8VPQ6OMAP2X3E1F7FDWLJPSO	blanc : : Un chenil peint en blanc se réchauffe moins vite que toute autre couleur.
es_3RWE2M8QWJNOIGTD8MIP1C4ZXYI0NZ	noir : : La couleur noire affecte la température à l'intérieur de la maison car le noir peut absorber plus de chaleur du soleil que les autres couleurs.
es_3RWE2M8QWJNOIGTD8MIP1C4ZZXKN0O	blanc : : Le blanc est meilleur car il semble que les autres couleurs absorbent plus d'énergie. L'intérieur de la niche se réchaufferait avec les peintures d'autres couleurs, de la même façon que le bocal en verre avec les couvercles d'autres couleurs se réchaufferait.
es_3RXCAC0YIT20QDHUGMI9471KEH68GD	blanc : : de plus en plus froid
es_3RXCAC0YIT20QDHUGMI9471KFGX8G3	blanc : : En choisissant le blanc pour peindre la niche du chien, on garantit un environnement plus agréable pour l'animal, car selon les résultats de l'expérience, les températures de _41 et 43 degrés Celsius sont les plus basses par rapport aux autres couleurs, le blanc est donc la bonne couleur pour la niche du chien.
es_3RXCAC0YIT20QDHUGMI9471KGF6G8J	noir : : température de l'air sur les catégories de table
es_3RXPCZQMQROIFDX9H19UPXEC4FM1GK	gris clair : : pas trop chaud et pas trop foncé
es_3RXPCZQMQROIFDX9H19UPXEC4YJG1Y	blanc : : Pour ne pas trop réchauffer le chenil.
es_3SITXWYCNXMUEXAR882NJVRGSDZBXM	gris foncé : : La température dans tous les studios pour la couleur gris foncé reste inchangée.
es_3SKEMFQBZ5I5SZDD6D3O2ZTDNL0K8H	gris clair : : Giris Light
es_3SKRO2GZ734NHZTS7SU9NP659SVK1O	blanc : : Le blanc semble être la couleur qui absorbe le moins d'énergie et maintient la température de l'air plus stable, la couleur la plus idéale pour la niche du chien est le blanc, cependant un certain type de matériau isolant est nécessaire pour réduire la température interne.
es_3SLE99ER0PQJJSA69QQ8GG7R1DWBZJ	blanc : : La couleur blanche affecte l'intérieur du chenil et le rend plus froid que s'il était d'une autre couleur. Les résultats de l'expérience indiquent que plus la couleur est claire, plus la température du chenil sera basse. Comme les chiens aiment vivre dans des températures plus fraîches, le blanc serait la couleur la plus appropriée.
es_3SNLUL3WO60EA228UGGUDROHAFCLUN	blanc : : Comme on peut le voir dans l'expérience et dans les résultats obtenus ci-dessus, plus la couleur de la couverture est foncée, plus la température sera élevée. Plus la couleur est foncée, plus la lumière sera absorbée et donc plus la température sera élevée. C'est pourquoi, si nous voulons obtenir une température plus élevée à l'intérieur de la maison, nous devons choisir la peinture la plus foncée, dans ce cas la couleur noire. Toutefois, pour éviter que l'intérieur du chenil ne soit trop chaud, il est conseillé de choisir une couleur plus claire, en l'occurrence le blanc.
es_3T3IWE1XG80A1M3WMGYGPH190L5QTU	blanc : : Le blanc attire moins l'énergie solaire, obtenant une température plus basse que le noir, qui attire plus l'énergie.
es_3TEM0PF1Q7AFW420JS4M57S5IZ60DG	blanc : : A première vue, je dirais blanc, mais cela dépend aussi de la température ambiante extérieure. Avec une chaleur extrême, la couleur idéale serait le blanc, et avec un froid extrême, la couleur idéale serait le noir. Salutations !
es_3TEM0PF1Q7AFW420JS4M57S5KLQD0N	blanc : : On a émis l'hypothèse que les couleurs sombres absorbaient la lumière et augmentaient la température. Comme la température de l'air mesurée à l'intérieur du conteneur augmentait avec les couleurs plus foncées, cela est clair. Le transfert de chaleur se fait par conduction à partir du plafond et par convection de l'air intérieur.
es_3TGOYF991ZZHTSP23U8V4EK0L3SUU5	blanc : : Dans les trois tests, la température moyenne de la couleur blanche était inférieure de _10 degrés à la température moyenne de la couleur noire .
es_3TMFV4NEPARWNZ7UVRMRQAN8BBG8WB	blanc : : La couleur blanche permet de maintenir une température basse à l'intérieur de la maison. La bouteille à bouchon noir présente les températures les plus basses.
es_3TOK3KHVJVVKICT9U03BVGERW9F7OI	blanc : : Le blanc aidera à refléter une partie de la température de l'intérieur tout en le maintenant à une bonne température la nuit.
es_3TOK3KHVJVVKICT9U03BVGERXTOO7D	blanc : : Plus la couleur de la niche est foncée, plus elle attire et absorbe les rayons du soleil, ce qui fait que la niche atteint des températures malsaines pour votre animal en été. Pour cette raison, peindre le chenil en blanc serait le plus approprié, car les rayons du soleil ne seraient pas absorbés par le chenil, celui-ci étant à l'extérieur.
es_3TOK3KHVJVVKICT9U03BVGERXXDO7A	blanc : : Si l'on utilise de la peinture blanche, la température à l'intérieur du chenil sera plus basse que si l'on utilise d'autres couleurs plus sombres comme le gris ou le noir.
es_3TS1AR6UQSRQCZGGVXKL8M5D2IRF7P	blanc : : on peut remarquer que plus la couleur est foncée, plus le thermomètre mesure de chaleur. Dans le cas du chenil, pour avoir une température plus basse, il faudrait utiliser la couleur la plus claire possible.
es_3TS1AR6UQSRQCZGGVXKL8M5D2LAF7E	blanc : : la couleur blanche rendrait le chenil beaucoup plus frais pour votre chien car le tableau indique qu'il s'agit du pourcentage de température le plus bas.
es_3TU5ZICBRFER32B8JINLYL5MK498Q2	noir : : La couleur noire permettrait de maintenir la température du chenil plus élevée que les autres couleurs.
es_3TVRFO09GMS6R6W3ZLRHXYNL680LXA	noir : : La couleur noire rendrait la température à l'intérieur du chenil plus élevée (la température moyenne après les _4 tests est plus élevée). Comme il s'agit d'un chenil extérieur (et en supposant un climat froid), le noir serait la couleur appropriée.
es_3TVSS0C0E3DFLJZIYPXMH6JVR5JWT6	blanc : : d'après les résultats de l'expérience, la couleur blanche a généré moins de chaleur à l'intérieur du récipient. Sur la base de ces résultats, il a été décidé de choisir la couleur blanche.
es_3U088ZLJVM6E5A2R0N9CXVHQU3X0WR	noir : : COULEUR NOIRE
es_3U0SRXB7CFICIADC2Z14L85M5MPNRN	blanc : : La peinture blanche reflète beaucoup plus le rayonnement de la lampe, par conséquent l'intérieur de la maison sera maintenu à une température plus basse que si la peinture noire était utilisée.
es_3U4J9857OGO0ZI40QVYPPWESQRY7BF	noir : : La température de la maison utilisant la couleur noire sera plus élevée parce qu'après trois tests, c'est la seule couleur qui a constamment démantelé d'avoir une température de plus de _50 degrés Celsius.
es_3U4J9857OGO0ZI40QVYPPWESSJ0B77	blanc : : Il est important que l'intérieur du chenil soit frais. Vous pouvez ajouter une couverture au cas où il ferait trop froid, mais il est difficile de réduire la température. Comme l'expérience a montré que la couleur blanche rendait l'intérieur plus frais, ils devraient peindre la niche en blanc.
es_3U5JL4WY5MMATYPITTS0BHLAFMDX4W	blanc : : Je pense que, si la niche est destinée à protéger le chien de la chaleur et du soleil, la couverture devrait être blanche car elle absorberait moins d'énergie et l'intérieur serait donc plus frais. Si, au contraire, la niche est destinée à protéger le chien du froid, la couverture doit être noire, car elle absorbera davantage de chaleur et de lumière et l'intérieur sera plus chaud.
es_3U5NZHP4LTFZW1BMM922BT8BNCMPHR	blanc : : comme on peut le voir dans les tests, le blanc est la couleur qui augmente le moins la température intérieure du chenil, donc en appliquant cette règle à la couleur de la niche, la couleur idéale est le blanc, qui s'est avéré être la couleur qui augmente le moins la température intérieure.
es_3U84XHCDIEQZYTPXUBGL821LSUR4Z1	blanc : : Plus la couleur du couvercle est foncée, plus la température à l'intérieur du chenil est élevée.  Il est moins important pour l'animal que la température soit stable et n'augmente pas brusquement. Plus la couleur est claire, mieux c'est.
es_3U84XHCDIEQZYTPXUBGL821LSXAZ4L	blanc : : Si l'on souhaite repousser la chaleur extérieure à l'intérieur du chenil, la couleur appropriée sera le blanc en raison de sa faible capacité à absorber l'énergie thermique, comme le montre le graphique réalisé à la suite de l'expérience précédente.
es_3UN61F00HY28SL76YZ5IRR50HEVR50	blanc : : les résultats du test indiquent que le blanc absorbe le moins de lumière, et donc chauffe le moins. C'est pourquoi elle a la température moyenne la plus basse.
es_3UOUJI6MTFR9AWJX8ZJIOLJ4H0KXU7	gris clair : : noir
es_3UXUOQ9OKGAVG8Z8KHYTULUMDW0A7P	gris foncé : : Le gris foncé serait une excellente couleur pour l'extérieur de la niche mais affecterait la température intérieure lorsqu'elle est exposée au soleil car, selon les résultats de l'expérience, le gris foncé a tendance à augmenter la température de l'air intérieur.
es_3V5Q80FXIZ4OAM3H5Q2OBMZ8OC623T	gris foncé : : Cette couleur est meilleure que le noir car elle maintient la température à un niveau confortable pour l'animal. Le noir serait trop chaud car le corps de l'animal est plus chaud. Le gris foncé ne sera pas très chaud mais il permettra de mieux réguler la température.
es_3VA45EW49P067QE75KM2U6NESX01OJ	gris clair : : Selon des expériences, la couleur blanche reflète beaucoup de lumière et réduit l'absorption de chaleur. Dans un environnement où le chien souhaite rester au frais à l'ombre, le blanc est la couleur idéale, car il permettra à l'intérieur de la niche d'être à une température plus basse que si elle était peinte en noir.
es_3VAR3R6G1REOIQYS45VH9GAM6N18O9	blanc : : avec cette couleur, la maison sera plus fraîche.
es_3VAR3R6G1REOIQYS45VH9GAM8D3O89	noir : : La couleur noire a donné les plus gros résultats parmi les autres.
es_3VBEN272MMCI9XW3UKOELY1LQB5SGP	gris foncé : : il rendra la maison plus chaude car l'énergie solaire pénétrera davantage à l'intérieur parce qu'il est plus foncé. C'était aussi la couleur avec le même score, donc la variété serait la même.
es_3VHP9MDGRPXWOGBCMESWO8XRA75FC4	noir : : la couleur peut être blanche
es_3VP0C6EFSI9DE9USYAJ6XYPQCS0M6X	noir : : le noir peut affecter l'intérieur de la maison, en augmentant la température de la pièce, il avait la température moyenne la plus élevée après _10 minutes à l'intérieur du bocal en verre.
es_3VP0C6EFSI9DE9USYAJ6XYPQCX76MY	blanc : : Selon ce tableau, la couleur parfaite est le blanc. Comme les tests _1, 2 et 3 correspondent parfaitement à cette couleur, les médiums correspondent aussi parfaitement. Donc la peinture de Jerry est parfaite pour choisir le blanc.
es_3W8CV64QJ4CE4EVF5K65P38WE8G9HO	blanc : : Empêche l'élévation excessive de la température à l'intérieur du chenil, assurant un environnement plus chaud pour le chien.
es_3WAKVUDHUYTFVHD6QMFKUM6GC9ZU74	gris clair : : La niche du chien ne doit pas surchauffer, je dois donc choisir une couleur claire. Avec le gris clair, la température sera fraîche, mais pas trop froide. Il y a environ _12 degrés de différence entre la température la plus élevée (noire) et la température la plus basse (blanche). C'est un changement très radical, et une maison blanche peut être trop froide en hiver. C'est pourquoi j'ai choisi le gris clair.
es_3WAKVUDHUYTFVHD6QMFKUM6GCOSU7R	gris clair : : GRIS LÉGER PARCE QU'IL GARDE LA TEMPÉRATURE CONTRÔLÉE
es_3WI0P0II6353WYMZD5N1P3TSTGQRDA	noir : : Le noir absorberait la lumière.
es_3WMOAN2SRDA4BHUTBJ6EM5UPQ0FVNH	blanc : : Définitivement, la couleur noire absorbe la lumière et la chaleur rayonnant de la lampe, c'est pourquoi pour garder le bâtiment plus frais, il est préférable d'utiliser le blanc.
es_3WOKGM4L73T601TP91I2G144QZFO0F	blanc : : Le blanc reflète généralement la lumière plutôt que de l'absorber. Bien que l'expérience montre que l'air extérieur se réchauffe toujours, mais il ne s'élève jamais au niveau du noir. Je pense que si la température reste plus basse à l'extérieur, elle restera aussi plus fraîche à l'intérieur de la boîte.
es_3WQQ9FUS6C74ZW9J00QV3WAN05R8BD	blanc : : haut contraste
es_3WR9XG3T65OGEJJRBGO2HI8MJNH47L	noir : : L'utilisation d'un couvercle noir pourrait augmenter la température de l'intérieur de la maison. D'après les résultats de l'expérience, nous pouvons constater que l'intérieur avec le couvercle noir présente la température la plus élevée de manière constante.
es_3WRFBPLXRC1KZ8SAR9083A260GV3N2	blanc : : Si la couleur est blanche, il y aura moins de chaleur à l'intérieur de la maison car les résultats montrent que si la couleur est plus claire, le couvercle absorbe moins de chaleur. Je suppose que Brandi et Jerry ne veulent pas que leur chien meure d'hyperthermie.
es_3WYGZ5XF3YSNBJSMKB9TJQTE0PVSKY	blanc : : En choisissant une couleur blanche pour la peinture de la maison, il fait moins chaud et plus confortable pour le chien. Ou, en choisissant une couleur plus sombre comme le noir, la température à l'intérieur de la maison augmentera, ce qui n'est pas bon.
es_3WYGZ5XF3YSNBJSMKB9TJQTEXSNSKT	noir : : il est certain que la couleur noire absorbera plus d'énergie, chauffant ainsi l'intérieur à une température plus élevée.
es_3X08E93BHXVBP690BUCP82S4F6B66I	blanc : : Si plus le couvercle de la boîte est foncé, plus la chaleur se condense à l'intérieur de la boîte, la niche du chien doit être aussi claire que possible pour que les rayons du soleil ne fassent pas monter la température.
es_3X1FV8S5JZ4Y1PD7OFTJWLLSSLZGVX	blanc : : D'après les résultats, plus la couleur est foncée, plus elle affecte la température.  La couleur blanche montre qu'elle a été la moins touchée.
es_3X3OR7WPZ1DGC5VVRDFPHZ6SF8RL8K	blanc : : La niche du chien doit être confortable. Le blanc absorbe moins la chaleur et c'est pourquoi il est le meilleur choix. Plus ils sont foncés, plus ils absorbent la chaleur, d'après les résultats.
es_3X4JMASXCOMMH74G5WDGAH45JU9B0Z	gris clair : : LE GRIS CLAIR EST LE MEILLEUR CHOIX CAR SI IL FAUT FROID, LE CHIEN SERA PROTÉGÉ DU FROID ET SI IL FAIT PLUS CHAUD, LE CHIEN AURA UNE MEILLEURE TEMPÉRATURE DANS SA CUISINE.
es_3X4MXAO0BI1254MQU0SRHRIDZ6ARWG	noir : : Avec le toit du chenil peint en noir et compte tenu des résultats de l'expérience, on peut supposer que la température à l'intérieur du chenil sera plus élevée qu'avec les autres couleurs lorsque le chenil est en plein soleil. Cette hypothèse ne tient pas compte de l'effet des éventuels flux d'air dans la hutte, car celle-ci n'est pas complètement fermée comme le bateau dans l'expérience décrite ci-dessus.
es_3X73LLYYQ3RZTGZ96UPA743GL3PHN1	blanc : : cette réponse est facile, je serai bref. Dans mon cours universitaire sur l'éclairage intérieur, j'ai appris que les couleurs claires sont les meilleures pour l'intérieur car elles permettent à la température et à la lumière émise par la lampe de se répandre.
es_3X73LLYYQ3RZTGZ96UPA743GNXGHNI	gris clair : : Selon la taille et la race de notre chien, nous différencierons _3 types de niches : les niches pour grands chiens, les niches pour chiens moyens ou les niches pour petits chiens. La niche parfaite pour votre chien est celle qui lui permet d'entrer sans problème, de se lever à l'intérieur, de se promener quand il est à l'intérieur et de se coucher. Si, au contraire, nous achetons une niche trop grande, il sera plus difficile de la chauffer et notre chien pourrait avoir froid, surtout en hiver, lorsque les températures sont généralement plus extrêmes.
es_3X87C8JFV8O9MMQHXGTQFC5NX7HQS4	blanc : : En supposant que le soleil soit directement au-dessus du chenil, d'après les résultats de l'expérience, la couleur idéale est le blanc, car elle permettra d'obtenir la température la plus basse possible pour le chien lors des journées chaudes.
es_3XC1O3LBOUZZAPNJUBQK8V2FOBWLT4	blanc : : Le blanc est la meilleure couleur car il maintient une température plus confortable pour le chien.
es_3XIQGXAUMEL7CL71VRQ7ET5K667X7K	gris foncé : : cette couleur pourrait affecter l'intérieur du chenil. Utilisez les résultats de l'expérience
es_3XXU1SWE8O8HYXZOZIDKF6KZYNI0A6	noir : : Si le chien vit dans une région froide, la couleur noire dans son chenil peut l'aider à maintenir une température plus chaude.
es_3Y5140Z9DZTZSWM6SRKNB59QL8PIP1	blanc : : Étant blanc, il absorbe le moins d'énergie, de sorte que le chenil restera plus frais pendant l'été chaud, comme le montrent les figures _1 et 3, ainsi que la moyenne de 41 degrés Celsius. Si la couleur idéale pour l'hiver est le noir, elle absorbera un maximum d'énergie et gardera la maison chaude.
es_3Y54SXRO1NY2TFAD3PILZIYY3OJUTB	blanc : : Le blanc absorbe moins d'énergie, ce qui maintient l'intérieur de la niche à une température plus basse et plus confortable pour l'animal.
es_3Y9N9SS8L0OBDW1X2FM575QCTZO3DW	blanc : : Permet de garder le chenil un peu plus frais.
es_3YDGXNSEO17KEXOALLG8VI4HOCP84I	blanc : : La couleur a un grand effet sur la maison. Plus la couleur est foncée, plus la maison sera chaude. Le blanc est donc la meilleure couleur pour la niche du chien.
es_3YDTZAI2WZT23X4PM07TG8H9A9614K	blanc : : La peinture blanche absorbe moins d'énergie que la peinture grise ou noire. Comme on peut le voir dans l'expérience, la température à l'intérieur du bocal en verre avec le couvercle blanc était la plus basse par rapport aux couvercles noir et gris. Par conséquent, la peinture blanche est le meilleur choix pour la niche du chien car elle maintiendra l'intérieur de la maison à une température plus basse que la peinture noire et grise.
es_3YDTZAI2WZT23X4PM07TG8H9CYT41Q	noir : : La maison perdrait de sa valeur.
es_3YGXWBAF72UMQ0EN2XWDX400MYO4CW	gris foncé : : Le gris foncé maintient la température à un niveau plus bas.
es_3YJ6NA41JDTVN76CA95NN6OQZDZJPG	blanc : : le blanc est la couleur idéale car elle n'apporte ni trop de froid ni trop de chaud.
es_3YMTUJH0DUT3CHGYOJR3ME042S5T4T	noir : : plus c'est sombre, mieux c'est.
es_3YOH7BII0BK33B9QE6EYUDDL1JBKVZ	blanc : : La couleur blanche se traduit par la température la plus basse à l'intérieur du chenil. Une niche sera exposée au soleil toute la journée et doit être maintenue fraîche pour que le chien soit à l'aise. Pour cette raison, peindre le chenil en blanc est le meilleur choix.
es_3YT88D1N0ABJR277UW8SBIL26RC3KV	gris foncé : : La couleur et l'obscurité n'affectent pas trop l'intérieur. Parce que le gris foncé permettra à suffisamment de lumière de pénétrer dans le chenil pour maintenir une température neutre.
es_3YW4XOSQKSY1KVY416YBTCF3DNNU1Z	blanc : : Il empêchera la température à l'intérieur du chenil de devenir trop chaude.
es_3Z3ZLGNNSK75255271SP74XB4IV3QJ	blanc : : Le blanc serait la couleur idéale pour que la température dans le chenil soit la plus fraîche possible pour le chien. Le choix de la couleur peut avoir une incidence sur d'autres aspects, comme la visibilité accrue de la saleté.
es_3Z7EFSHGNBRDO22XM8YIUFXY74HCXL	blanc : : La meilleure couleur à utiliser est sans aucun doute le blanc. En fait, cela empêche une surchauffe excessive pour éviter les brûlures, car le blanc dévie les particules de lumière et surchauffe moins.
es_3Z7ISHFUH280HUCZ6E6YPEHQPAL8ZT	blanc : : Le seul effet du blanc est que, dans tous les tests, il maintient une température inférieure à celle des autres tests, car il s'agit d'une couleur claire et la clarté fait qu'elle reflète la température et n'atteint pas une température élevée.
es_3Z7VU45IP0UI6USE7TXJA4UIHVZZ18	blanc : : La couleur blanche empêchera la température à l'intérieur du chenil d'être trop élevée, car elle reflète la lumière.
es_3ZPPDN2SLX92K44DFJYZ40BJTS39EU	gris clair : : gris clair
es_3ZSANO2JCHKCVX08J0IW3D19T52FSW	blanc : : parce que plus la couleur est foncée, plus l'environnement de la niche sera chaud, si une couleur claire comme le blanc est utilisée, elle chauffera moins car elle réfléchira plus facilement la chaleur du soleil.
es_3ZSY5X72NZOU0VDO3E1H0X5RVV3ROD	gris clair : : Selon les résultats de l'expérience précédente, plus la couleur est foncée, plus l'objet sera chaud. Le gris clair me semble être une couleur appropriée car l'objet aurait, en théorie, une température régulière.
es_3ZV9H2YQQFKAM21OJARVZTFXSMO3W5	blanc : : le blanc est la couleur qui absorbe le moins d'énergie, ce sera donc la couleur qui donnera la température la plus basse à l'intérieur de la niche du chien.
es_3ZWFC4W1UWK0UI0V4BIRD3WD37ERFJ	blanc : : il a été scientifiquement prouvé que le blanc est _22% moins chaud que le noir, c'est donc la couleur la plus appropriée pour la niche du chien, car elle la gardera aussi fraîche que possible.
es_3ZWFC4W1UWK0UI0V4BIRD3WD3V9RFQ	gris foncé : : Le gris foncé est la meilleure option, il garde le chien au chaud mais pas trop comme le noir. En fin de compte, tout dépend du climat. Si le climat est chaud, la peinture blanche est la meilleure option, mais si le climat est froid, le noir ou le gris foncé sont les meilleures options.
