id	text
es_3018Q3ZVOK35YRJNTVWZZ2LMBENRA7	weiß :: Das Experiment zeigt, dass die Temperatur im Zwinger umso niedriger ist, je heller die Farbe ist. Um dem Hund tagsüber eine erträglichere Temperatur zu bieten, begünstigt die weiße Farbe also eine kühle Temperatur im Zwinger.
es_3018Q3ZVOK35YRJNTVWZZ2LMDXXAR4	Weiß :: Weiß kann das Haus mit einer niedrigeren Temperatur verlassen, da es die Temperatur nicht so stark erhöht wie die anderen Farben.
es_304SM51WA5HMIGOSEYW0KNAOI0CSBJ	weiß :: Das große Haus kommt in Sicht
es_308Q0PEVBAQE096ZB2OQPF9BKSU9I0	hellgrau :: Nach dieser Tabelle, die vier verschiedenen Tabellen schwarz, dunkelgrau, hellgrau weiß Meine Wahl ist hellgrau, weil es perfekt für Hausmalerei ist.
es_308XBLVESKHAH1OFZ9WVUD5SV4ABR6	weiß :: Die Farbe weiß wird die niedrigste Temperatur im Haus.  Das Experiment bestätigt diese Schlussfolgerung, da die Temperatur im Inneren des Bootes bei Weiß niedriger war als bei den anderen Farben (Schwarz, Grau usw.).  Wenn es also heiß ist, ist Weiß für mich die beste Farbe für einen Unterschlupf, aber auch nur, weil es mehr Licht reflektiert, wenn es heiß ist.
es_30H4UDGLT4VLOFCXD6IF3YG74D7PMG	weiß :: Je dunkler die Farbe der Hundehütte ist, desto wärmer wird sie sein, da dunkle Farben mehr Energie absorbieren. Wie aus den Ergebnissen des Experiments hervorgeht, ist die Temperatur im Zwinger umso niedriger, je heller die Farbe ist. Da die hellste Farbe weiß ist, ist sie die bevorzugte Farbe, da sie für den Hund die angenehmste Temperatur ergibt.
es_30IQTZXKAMJTUA7HAS5YZEVX1AY0XN	weiß :: Aufgrund der Ergebnisse sollte die Hundehütte weiß sein, weil sie dadurch kühler bleibt und der Hund nicht überhitzt.
es_30LB5CDZNENIZ57WBATJWZB87AM0Z8	Schwarz :: Ich habe Schwarz gewählt, weil es die Temperatur der Luft im Inneren eines Bootes erhöht und wir so sehen werden, wie es die Farben beeinflusst.
es_30X31N5D653HZ6J08KW4PCQISR8ASX	weiß :: Weiß absorbiert weniger Licht, so dass die Temperatur im Inneren des Gebäudes weniger ansteigt.
es_30ZX6P7VFA8ZV0568BUBRTGXKAC2JR	weiß :: Die weiße Farbe kann dazu beitragen, die Temperatur im Inneren der Kassette zu senken, was in heißen Klimazonen von Vorteil ist. Wie Sie sehen können, ist die durchschnittliche Temperatur mit dem weißen Deckel die niedrigste von allen dunkleren Deckeln.
es_30ZX6P7VFA8ZV0568BUBRTGXKD0J22	hellgrau :: Es würde mehr Licht in den Schuppen lassen und eine kühlere Atmosphäre im Inneren des Schuppens schaffen.
es_317HQ483I95ZPBATCC7V7G4VP67INI	schwarz :: Die schwarze Farbe könnte das Innere des Schutzraums beeinträchtigen, da dunkle Farben mehr Energie absorbieren. Bei den Tests erzielte die schwarze Farbe die besten Ergebnisse, da sie mehr Energie absorbiert. Der Durchschnitt der schwarzen Farbe liegt bei 53.
es_3180JW2OT6PRUXOTQUW9P0J965QJ54	weiß :: Ein weißer Zwinger sollte die Temperatur im Inneren des Zwingers weniger von der Außentemperatur beeinflussen. Mit anderen Worten: Wenn es draußen sehr heiß ist, fühlt sich der Hund im Zwinger wohler. Wenn es kalt ist, weil es draußen keine Wärmequelle gibt, macht es keinen Unterschied, ob der Zwinger schwarz ist, da er ohnehin nicht wärmer ist.
es_3180JW2OT6PRUXOTQUW9P0J98C25JI	weiß :: Die allgemeine Formel besagt, dass dunkle Farben Wärme absorbieren, so dass die schwarze Farbe die Wärme erhöht.
es_31EUONYN2XGMT2U5CY6R1UUUG7WOVV	Hellgrau :: Um eine genauere Antwort zu geben, müsste man das Material des Gebäudes kennen, aber a priori, basierend auf dem gleichen Theorem, das in der Übung enthalten ist, d.h. in Anbetracht der Tatsache, dass dunkle Farben mehr Energie absorbieren, und wir nicht wissen, ob sich das Gebäude in einem Gebiet mit extremer Hitze oder extremer Kälte befindet, ist es am besten, sich für eine neutrale Antwort zu entscheiden, die im Winter die größtmögliche Wärme und im Sommer die geringstmögliche Hitze liefert.
es_31JLPPHS2W72HTSMSO0LIZ2BT8DO3I	weiß :: Die Farbe weiß wirkt sich auf das Innere des Schutzraumes aus, da hellere Farben weniger Energie absorbieren als dunklere Farben wie Schwarz.
es_31JLPPHS2W72HTSMSO0LIZ2BURA3OX	weiß :: Die weiße Farbe absorbiert nicht so viel Wärme wie die anderen Farben, und es wäre besser, wenn sich der Zwinger nicht so stark aufheizt, damit der Hund nicht unter der Sommerhitze leidet.
es_31LM9EDVON5VKMUZUUSVJHJV26QJNV	weiß :: Ich habe weiß gewählt, damit die Temperatur sowohl im Winter als auch im Sommer angenehm ist.
es_31LVTDXBL9NMUAARQMLP8G1X1WARLL	Schwarz :: Nutzen Sie die psychologische Wirkung von Schwarz, um einen eleganten und kühnen Look für Ihr Zuhause zu schaffen. Wenn es intelligent eingesetzt wird, verleiht Schwarz der Inneneinrichtung eine elegante und anspruchsvolle Ausstrahlung. Vor einem hellen oder neutralen Hintergrund hebt sich alles, was schwarz ist, ab. Schwarz ist ideal, um bestimmte Dinge in einem Raum hervorzuheben. Die meisten Menschen assoziieren Schwarz mit Tod, Trauer, Witwenschaft und allgemein mit formellen und ernsten Anlässen. Schließlich sollten Sie nicht zu viel Schwarz verwenden, sondern nur bestimmte Dinge wie Bilderrahmen, kleine Tische usw. hervorheben.
es_31LVTDXBL9NMUAARQMLP8G1X2TCRLI	schwarz :: DIESES EXPERIMENT FÜHRTE ZU DEM ERFOLG, DASS DAS INNENGEBÄUDE DURCH DIESE LAMPE UND IHRE HÖHERE TEMPERATUR AUCH ZU SCHWACH WAR. DIE HELLIGKEIT DES INNENRAUMS BEEINTRÄCHTIGT WURDE.
es_31Q0U3WYDRSZMKM8OY50JK1J80W71V	dunkelgrau :: Nach dieser Tabelle sind die vier verschiedenen Tabellen schwarz, dunkelgrau, hellgrau, weiß Meine Wahl ist hellgrau, weil es perfekt für den Hausanstrich ist.
es_31QNSG6A5T6HXK6TNJEFYUORGDU87G	weiß :: Die weiße Farbe reflektiert mehr Licht, so dass die Temperatur nicht zu sehr ansteigt, wenn der Hund bei heißem Wetter im Zwinger ist.
es_31UV0MXWNSPVZM4N8CB9DZ49WBL5I7	weiß :: Dies ist die Farbe, die den Zwinger am wenigsten aufheizen würde, da das Experiment die ursprüngliche Hypothese bestätigt, dass je dunkler die Farbe ist, desto mehr Energie absorbiert sie. Mit dem weißen Zwinger hätte der Hund an sonnigen Tagen einen kühleren Unterschlupf.
es_326O153BMKBENUHURZ31QWU9F01ED4	Dunkelgrau :: Dunkelgrau kann dazu beitragen, dass weniger Energie verbraucht wird, egal zu welcher Tageszeit das Gebäude der Sonne ausgesetzt ist. Klimaanlagen oder Heizungen benötigen viel Strom, um einen Raum tagsüber und nachts auf einer konstanten Temperatur zu halten. Wenn alle Tests mit einer Temperatur von 24 °C begannen und die Temperaturen folglich nach unterschiedlichen Zeiten aufgezeichnet wurden, wurde die graue Farbe nicht beeinflusst, egal wie lange der Deckel dem wärmeerzeugenden Licht ausgesetzt war. Dies ist vergleichbar mit der Sonneneinstrahlung auf ein Gebäude und den Stunden, die das Gebäude der Sonne ausgesetzt ist.
es_32EYX73OY2MPD0XLZ0DQZ3XGEKEURN	weiß :: Cmit der Wärmeeinwirkung steigt die Temperatur nicht so stark an wie bei den anderen Farben.
es_32KTQ2V7RFS0WSWQWHMIH8GS19NM9I	weiß :: Die weiße Farbe würde das Haus so kühl wie möglich machen, mit einer durchschnittlichen Temperatur von 42º.
es_32KTQ2V7RFS0WSWQWHMIH8GSU9M9MX	schwarz :: Da Ihr Hund es gerne warm hat, ist schwarz die beste Farbe für die Hundehütte. Die Ergebnisse des Experiments zeigen, dass Schwarz mehr Energie absorbiert, weil die Temperatur der schwarzen Abdeckung stärker ansteigt.
es_32M8BPYGAVZTFJT7P8U0HWVYIFDIG2	weiß :: Weiß würde die Temperatur im Haus das ganze Jahr über viel kühler halten. Wie aus dem obigen Diagramm hervorgeht, ist dies die kälteste Temperatur auf allen Skalen. Weiß hat eine hohe Albedo, was bedeutet, dass es die Temperaturen kühl hält.
es_32RIADZISUH2XH3JZJMDC94I07D4SX	weiß :: Die weiße Farbe reduziert die Aufheizung des Zwingerinneren durch die Sonne und der Hund wird sich wohler fühlen.
es_32RIADZISUH2XH3JZJMDC94I08B4SX	weiß :: Wenn das Gebäude weiß gestrichen wird, steigt die Temperatur im Inneren des Gebäudes nicht so stark an, wenn es intensiver Sonneneinstrahlung oder künstlichem Licht ausgesetzt ist.
es_32SCWG5HIJHJZCR5QQBYE2JL9DO6PE	weiß :: Die Farbe Weiß reflektiert weniger Wärme im Inneren des Gebäudes, daher sollte das Gebäude weiß gestrichen werden, um die Temperatur im Inneren des Gebäudes zu senken.
es_32SVAV9L3HMDFPYLI5V3H4I671K3AW	schwarz :: Die schwarze Farbe erhöht die Temperatur der Luft im Inneren des Behälters. Das Experiment beweist, dass seine Hypothese richtig war, da die Temperatur höher war und somit mehr Energie absorbiert wurde.
es_32UTUBMZ7I92A85W8T15VAUVA57BV3	hellgrau :: Die hellgraue Farbe würde die Temperatur im Haus ansteigen lassen, aber nicht so stark. Die Ergebnisse des Experiments zeigen, dass bei der Farbe Schwarz die Temperatur um mehr als das Doppelte der Ausgangstemperatur ansteigt, bei Hellgrau jedoch um etwas weniger als das Doppelte der Ausgangstemperatur.
es_32ZKVD547H0IYZ3DOJVZCF2CL9U3BS	weiß :: Durch die weiße Farbe bleibt das Haus weniger warm. Sie absorbiert die Sonne nicht so stark.
es_32ZKVD547H0IYZ3DOJVZCF2CNTK3BO	weiß :: Durch die Verwendung von Weiß bleibt die Temperatur im Inneren des Zwingers kühler und angenehmer für den Hund.
es_336YQZE83XRHV5UETR915SBQC7QM5Y	weiß :: Je heller die Farbe ist, desto weniger Energie absorbiert sie, so die Ergebnisse. Die weiße Farbtemperatur ist niedriger als die schwarze Farbe.
es_337RC3OW07FENHR8Z6QZ9DQ0M1BVL4	weiß :: Das Experiment zeigt, dass die Farben von Gegenständen die Temperatur der Räume, die sie enthalten, beeinflussen, indem sie zeigen, dass helle Farben wie Weiß die Erwärmung der in einem Gegenstand enthaltenen Luft verlangsamen, im Gegensatz zu dunklen Farben wie Schwarz, die die Erwärmung der in einem Gegenstand enthaltenen Luft beschleunigen.
es_338JKRMM28CS9X5KXQK5LYJGR9LAH0	weiß :: Nach dem Experiment war weiß die Farbe, die die Lufttemperatur am niedrigsten hielt, im Vergleich zu den anderen Farben, grau, dunkelgrau oder schwarz. Wenn Sie also eine kühle Temperatur im Haus beibehalten wollen, würde ich mich für Weiß entscheiden.
es_33CID571066UB8PPFWKTQIYHUEG3L6	weiß :: Die weiße Farbe wirkt sich auf den Zwinger aus, indem sie das Sonnenlicht reflektiert und so den Innenraum kühl hält, ohne dass die Gefahr besteht, dass die Luft überhitzt und das Tier erstickt. Wie aus der Tabelle ersichtlich ist, weist die weiße Farbe die niedrigsten Temperaturwerte auf, während mit zunehmender Dunkelheit auch die Temperatur steigt und bis zu 54 ºC erreicht.
es_33CKWXB73LXLBY76ZIORIAA6YV711U	weiß :: Weiße Materialien reflektieren mehr Lichtenergie und Wärme als Materialien mit dunklerer Farbe. Daher wird eine Konstruktion aus leichteren Materialien eine niedrigere Innentemperatur aufweisen als eine Konstruktion aus dunkleren Materialien. Dies wird im Experiment deutlich, denn der Behälter mit dem weißen Deckel erreichte bei den drei wiederholten Versuchen eine durchschnittliche Temperatur von nur 42 °C. Der Kanister mit dem schwarzen Deckel erreichte dagegen in drei Versuchen 53°C. Die Kanister mit hellgrauen und dunkelgrauen Deckeln wiesen erwartungsgemäß mittlere Temperaturen auf.
es_33F859I568QXS7AC34K1G93M3X8BH4	weiß :: Das durchgeführte Experiment hat gezeigt, dass die weiß gestrichenen Objekte die geringste Temperaturerhöhung in ihrem Inneren aufweisen, da die Temperatur während der Exposition nur um 18 °C anstieg, und in Anbetracht der Tatsache, dass es sich um ein Haus für einen Hund handelt, der es schwieriger findet, seine Temperatur zu regulieren, ist es günstiger, wenn die Temperatur nicht zu stark ansteigt.
es_33FOTY3KEOY5Y1H4FFDBZ6TX3JA1CF	weiß :: Mit dem weißen Deckel erreichte die Lufttemperatur im Inneren des Behälters bei allen Tests die niedrigsten Werte. Es wird daher angenommen, dass in einem Haus ähnliche Ergebnisse erzielt werden würden.
es_33ISQZVXPRZPL4R2VC2VG2CO716CCR	hellgrau :: ABHÄNGIG VOM KLIMA IST ES GUT ZU WISSEN, WELCHE DIE BESTE TEMPERATUR FÜR DAS HAUSTIER IST, AUCH DER ABSTAND VON DER LAMPE IST EIN BESTIMMENDER FAKTOR, ICH WÜRDE EINE NEUTRALE FARBE WÄHLEN, BEI DER DIE TEMPERATUR NICHT SO VIEL SCHWANKUNG HAT !!!!
es_33ISQZVXPRZPL4R2VC2VG2CO728CCV	weiß :: Lichtenergie kann absorbiert oder reflektiert werden. Dunkle Oberflächen und Objekte absorbieren Licht und wandeln es in Wärmeenergie um, wodurch sich die Temperatur des Objekts wärmer anfühlt. Das Ziel unseres Zwingers ist es, so viel Wärmeübertragung wie möglich zu verhindern, damit unsere Welpen kühl bleiben. Indem wir die Wärme drinnen halten, machen wir den Innenraum kühler. Der weiße Zwinger reflektiert mehr Licht als dunkle Farben. Der weiße Zwinger sollte innen am kühlsten sein. Der schwarze Zwinger absorbiert das meiste Licht, und diese Energie wird mit der Zeit ins Innere des Zwingers übertragen und erwärmt das Innere.
es_33IZTU6J83ETVJRTJUOI9K1G1MUXST	weiß :: Die weiße Farbe hält die Lufttemperatur im Inneren des Hauses sehr kühl.
es_33IZTU6J83ETVJRTJUOI9K1GXNVSXN	weiß :: Weiß absorbiert Wärme und ist daher die beste Farbe für den Anstrich des Schuppens. Wie Sie sehen können, sind die Lufttemperaturen mit Weiß am besten.
es_33LKR6A5KGXMKIJF1181OGT1VA71T9	weiß :: Weiß ist die ideale Farbe, denn zu viel Wärme ist nie gut für einen Hund.
es_33PPUNGG3AI6ZZRV5NCYGVCVMHIZR6	weiß :: Nach den Angaben in der Tabelle absorbiert weiß die wenigste Wärme und hält die Temperatur unter 45 Grad Celsius. Weiß ist die beste Wahl für Brandi und Jerry.
es_33TIN5LC06N0Q9L4FKATB33ZAK99Y5	Weiß :: Die Farbe Weiß macht das Innere des Hauses kühler als die anderen Farben. Den Angaben zufolge senkt Weiß die Innentemperatur stärker als die anderen Farben.
es_33UKMF931BXNT2VO3KSBUMCWQO2TT7	weiß :: weiße Farbe, weil sie weniger Wärmeenergie absorbiert und daher die Temperatur im Inneren des Gebäudes niedriger sein wird.
es_34BBWHLWHCOPC5J74DYI3ZHMF5OWI7	weiß :: An einem warmen Ort mit viel Sonne würde eine helle oder weiße Farbe die Temperatur im Inneren des Zwingers so niedrig wie möglich machen, mit einem Unterschied von bis zu 12º im Vergleich zu einer schwarzen Farbe.  Je nach Standort des Zwingers könnte man ihn auch in einer dunklen Farbe streichen, um diese Temperatur zu erhöhen.
es_34FNN24DCOMHPMJSCUXCZNYXHNO5YZ	schwarz :: Aus den durchgeführten Tests geht hervor, dass die Farbe Schwarz die Temperatur deutlich stärker erhöht als die anderen Farben. Denn je dunkler die Farbe, desto mehr Energie absorbiert das Objekt in dieser Farbe.
es_34FNN24DCOMHPMJSCUXCZNYXHZGY58	weiß :: Die weiße Farbe absorbiert nicht so viel Energie, so dass das Gebäude nicht so viel Wärme speichern kann. Es ist eine gute Wahl, wenn Jerry und Brandi in einem sehr heißen Klima leben. Wenn es für ein kaltes Klima ist, wäre schwarz effizienter und ideal.
es_34FNN24DCOMHPMJSCUXCZNYXLCB5Y4	weiß :: Die weiße Farbe macht die Hundehütte im Sommer kühler.
es_34HJIJKLP79IP9KNTERINWOPZAPV49	weiß :: Weiß stößt mehr Energie ab als dunkle Farben, so dass ein weißes Dach die beste Möglichkeit ist, die Temperatur in der Hundehütte zu senken.
es_34HJIJKLP79IP9KNTERINWOPZILV4L	blanco :: El color blanco mantendría la casa más fresca, no absorbe tanto la energía como el color blanco.(Weiß wäre das Beste für die Hundehütte, es würde das Haus frischer halten, da Weiß nicht so viel Energie absorbiert wie Schwarz)
es_34MAJL3QP60YD0I494LC41W681F34P	hellgrau :: Mit dieser Farbe ist eine durchschnittliche Temperatur von etwa 45 Grad möglich, wie aus der beigefügten Versuchstabelle hervorgeht. Vielleicht eine geeignete Temperatur für einen Hund und wenn man bedenkt, dass das Licht im Test die Funktion der Sonne übernimmt...
es_34PGFRQONQOL7G3DMVJIF0WMPE7WJY	weiß :: Die weiße Farbe senkt die Temperatur im Inneren des Gebäudes.
es_34Q075JO1ZQL49MO3ZKR45RWT4110T	weiß :: Da dunkle Farben mehr Energie absorbieren und die Luft im Gebäude aufheizen, wird ein weißer Anstrich zu einem kühleren Gebäude führen.
es_34QN5IT0T143F9692KT6JFE477Y805	weiß :: Weiß ist die einzige Farbe, die eine Temperatur von 43° oder weniger beibehält. Weiß ist die Farbe, die am wenigsten Wärme von der Sonne absorbiert. Es ist günstiger, ein weißes Haus zu haben, damit es im Sommer nicht so viel Wärme zurückhält.
es_34QN5IT0T143F9692KT6JFE4CUG08U	weiß :: Nach den Ergebnissen des Experiments. Die weiße Abdeckung ist diejenige, die die von der Lampe abgegebene Wärme isoliert oder reflektiert. Eine Hundehütte sollte also ein Dach in dieser Farbe haben, wenn man möchte, dass sich der Hund wohl fühlt. Es sollte jedoch festgelegt werden, ob der Zwinger in gemäßigten Klimazonen oder im Winter verwendet werden soll.
es_34S9DKFK752LFBPYGUTYT4YJEU6YNE	weiß :: Dunkle Farben absorbieren mehr Energie, so die Ergebnisse dieser Studie. Weiß absorbiert weniger Energie und ist daher weniger warm, so dass das Innere der Hundehütte kühler und weniger heiß ist.
es_34T446B1C2R5RCWMJW9BL1AN5TW0CE	weiß :: Denn wenn man die Farbe schwarz macht, wird es innen zu heiß. Die weiße Farbe ist besser, weil die Temperatur dann niedriger bleibt.
es_34V1S5K3GUEY7PBY91F1SCJ64DX96L	hellgrau :: Ich würde mich für hellgrau entscheiden, da es im Sommer nicht so heiß ist und im Winter nicht ideal, aber zumindest nicht so kalt, wie es mit Weiß sein könnte. Je schwärzer die gewählte Farbe, desto wärmer ist das Haus.
es_34V1S5K3GUEY7PBY91F1SCJ683896G	weiß :: Wie bei diesem Experiment erwartet, zeigen die gesammelten Daten, dass dunkle Farben mehr Energie absorbieren als helle Farben. Weiß absorbiert die geringste Menge an Strahlung. Die weiße Hütte erwärmt sich am wenigsten, wenn sie der Sonne ausgesetzt ist.
es_34X6J5FLPVBGNJ7RAMKCNBE03JPQJ1	weiß :: Die Farbe Weiß oder helle Farben machen den Zwinger im Allgemeinen weniger warm, und da wir einen Zwinger für einen Hund bauen, sollte er idealerweise eine helle Farbe haben, damit das Tier eine möglichst angenehme Temperatur hat. Wenn wir eine dunkle Farbe verwenden würden, würde die Temperatur auf mehr als das Doppelte der Außentemperatur ansteigen, wie das Experiment mit der Lampe zeigt.
es_351SEKWQS2UCZI978XRK34ZILU7MDX	weiß :: Die Farbe weiß hält die Temperatur im Haus niedriger als alle anderen Farben. In allen drei Tests war weiß immer die Farbe, die die niedrigste Temperatur erreichte.
es_352YTHGROXQD78P3OPAE8VXGV0S4HK	schwarz :: Schwarz
es_352YTHGROXQD78P3OPAE8VXGYDI4H3	weiß :: Diese Farbe sorgt dafür, dass die Temperatur im Haus nicht zu hoch ist, besonders im Sommer.
es_354P56DE9MGZG4L21HKKFLOSR8H7SW	weiß :: Aufgrund des Experiments würde ich sagen, dass weiß die richtige Farbe ist, da sie nicht viel Energie absorbiert.
es_354P56DE9MGZG4L21HKKFLOSSBAS7H	blanco :: Blanco
es_358010RM5G69NB8XDPTNK7LNS8OXVQ	weiß :: Die Temperatur im Haus sollte niedriger sein als bei einer der anderen Farben.
es_358010RM5G69NB8XDPTNK7LNU96XVC	weiß :: Die beste Farbe für den Zwinger ist weiß, da sie die Temperatur des Zwingers senkt. Da der Hund ein Lebewesen ist, ist es wichtig, dass der Zwinger eine angenehme Temperatur hat.
es_35GMH2SV3GU5RR8JH8HH1Q68MYXOE7	schwarz :: Ich denke, die Farbe ist mehr von den Medien erfüllt, sie sind grüner als die anderen.
es_35H6S234SCDF629M6B2KGWE4IGZ65A	weiß :: Weiß hält die Temperatur im Haus niedriger als eine dunkle Farbe.
es_35H6S234SCDF629M6B2KGWE4KN356T	weiß :: Die Temperaturen, die mit der weißen Farbe erreicht werden, sind die niedrigsten, aber mit 41 bis 43 Grad Celsius ist dies eine sehr hohe Temperatur für einen Hund in einem Zwinger.
es_35K3O9HUADQBLEVQI5YREWXUOC5FEZ	weiß :: In dem Experiment führte der weiße Deckel zu einer niedrigeren Temperatur im Topf. Wenn das Haus also weiß gestrichen ist, steigt die Innentemperatur nicht so stark an wie bei einer der anderen Farben.
es_35K3O9HUADQBLEVQI5YREWXUP47FEM	Weiß :: Die Verwendung von Weiß hält die Temperatur im Haus kühler als die Verwendung dunkler Farben.
es_35L9RVQFCQVCO6JI3V1WLZVAWKVHUF	weiß :: Die beste Farbe ist zweifellos weiß, da sie weniger Wärme absorbiert als dunklere Farben. Weiß könnte eine gute Farbe sein, denn im Sommer, wenn die Temperaturen normalerweise hoch sind, wird der Zwinger seine Temperatur nicht übermäßig erhöhen. Das liegt daran, dass Licht, das auf helle Oberflächen fällt, reflektiert wird, während Licht, das auf dunkle Farben fällt, absorbiert wird. Dies erklärt, warum in unserem Experiment die Temperatur im Inneren des Behälters umso höher ist, je dunkler die Farbe ist.
es_35L9RVQFCQVCO6JI3V1WLZVAXOPUHV	blanco :: CONSIDER TO BANOS
es_35L9RVQFCQVCO6JI3V1WLZVAY8YHUW	weiß :: Die Verwendung eines weißen Deckels sorgt dafür, dass es im Inneren des Zwingers nicht so heiß ist. In dem Versuch erreichte das Glas mit dem weißen Deckel nur 42 Grad, während das Glas mit dem schwarzen Deckel 53 Grad erreichte, so dass es für den Hund besser wäre, den weißen Deckel zu verwenden. Das wäre cooler.
es_36AHBNMV1TPCTZYLR0FVXZMPX0PDYD	weiß :: Die beste Farbe für die Hundehütte ist weiß, da hier die Temperaturen mit durchschnittlich 42ºC am niedrigsten sind.
es_36H9ULYP647JWUHIW69IBCAMTDUJF3	Dunkelgrau :: Die beste Farbe wäre Dunkelgrau, denn obwohl die Temperatur stärker ansteigt als bei Weiß, bleibt sie bei Grau konstant, was auch für die Wintermonate nützlich ist, da es nicht so schnell abkühlt.
es_36H9ULYP647JWUHIW69IBCAMTEDFJK	weiß :: Die Hypothese des Experiments wurde getestet: dunklere Farben absorbieren mehr Wärme, und so stellte sich heraus, dass das Innere des Zwingers mit dem schwarzen Deckel wärmer war als mit dem dunkelgrauen Deckel, und der dunkelgraue Deckel war wärmer als der Zwinger mit dem hellgrauen Deckel, und so weiter. Wenn ich eine Hundehütte entwerfen würde, würde ich sie in einer helleren Farbe gestalten, damit sich das Innere so wenig wie möglich aufheizt.
es_36NEMU28XHQB8O9YPSWAVSO3SL7MWM	Weiß :: Da dunkle Farben mehr Energie absorbieren, ermöglichen wir durch die Verwendung von Weiß eine niedrigere Temperatur im Inneren des Gebäudes.
es_36PW28KO419GPNEI7PCZ0VM3Y8NEAB	gris claro :: Helles Grau :: Helles Grau, weil es nach den drei Tests und dem letzten Test mit dem Durchschnitt als das beste herauskommt.
es_36TFCYNS46N45ADD80CJ56UEKQQHXR	weiß :: Die Temperatur im Haus würde niedriger sein, da Weiß weniger Energie anzieht.
es_36V4Q8R5ZMD6ORDCDJX4336H4CPMQ1	weiß :: Diese Farbe würde weniger Energie absorbieren und die Temperatur wäre nicht so heiß, daher ist es für den Hund wichtiger, sich an sein neues Zuhause anzupassen. Wäre es dunkel, würde der Zwinger mehr Energie absorbieren und sich schneller aufheizen, und der arme Hund würde krank werden, weil es so heiß werden kann.
es_36V4Q8R5ZMD6ORDCDJX4336H4HQQMG	weiß :: Ein weißer Anstrich des Hauses trägt dazu bei, dass die meisten Sonnenstrahlen nach außen reflektiert werden, wodurch das Material des Hauses weniger warm wird und weniger Wärme in das Haus eindringt, wodurch es kühler wird und die Wahrscheinlichkeit sinkt, dass der Hund das Haus verlässt und in das Haus der Besitzer geht. In dem Versuch hat der weiße Deckel dafür gesorgt, dass sich das Innere der Dose so wenig wie möglich erwärmt hat, was darauf hindeutet, dass sich das Haus durch die weiße Farbe weniger stark aufheizt als durch die anderen Farben.
es_36V4Q8R5ZMD6ORDCDJX4336HB55QME	weiß :: Die Farbe reflektiert das Licht besser
es_36W0OB37HYRTA5DS9I042RAPVW9ZH6	blanco :: BLANCO IST PERFEKT FÜR DAS BESTE PRODUKT
es_36ZN444YTTBH7WA5DR78M540B2TIOI	schwarz :: die schwarze Farbe hielt die höchste Temperatur.
es_373ERPL3YQLADNIWZVNGU7BEZYRRT1	Weiß :: Den Experimenten zufolge ist die weiße Farbe effizienter als andere Farben, was dazu beiträgt, dass das Innere des Hauses kühl bleibt. Alle Versuchsergebnisse zeigen, dass sie weniger Wärme absorbiert als andere.
es_374TNBHA8D86I82QWMLFXYTOJW4QYM	weiß :: Es geht nicht um die Erhöhung der Temperatur, sondern um Lichtabsorption und -reflexion. Farben mit einer hohen Wellenlänge absorbieren mehr Licht und werden in Wärme umgewandelt, während Farben mit einer niedrigen Wellenlänge Licht reflektieren.
es_379J5II41QTXL65M4G1P992EQEWLEW	weiß :: Je dunkler die Farbe des Unterstandes ist, desto weniger steigt die Lufttemperatur im Inneren des Unterstandes an.  Wenn die Sonne scheint und es draußen heiß ist, hält das Innere eines weißen Zwingers eine niedrigere Temperatur als ein grauer oder schwarzer Zwinger.  Wenn es sich um kaltes Wetter handelt, ist es wahrscheinlich besser, Schwarz zu wählen, um die Temperatur im Haus zu erhöhen.
es_37C0GNLMHHGAAFOFLHK3E82WVUND69	schwarz :: Die schwarze Farbe würde sich positiv auswirken, da die Lufttemperatur bei schwarzer Farbe am höchsten ist.
es_37Q970SNZGLL5I60C13BEBXFQASS19	weiß :: Die weiße Farbe ist besser für Ihren Hund, da sie die Temperatur weniger erhöht als schwarz oder andere Farben. Je dunkler die Farbe, desto mehr Energie absorbiert sie und desto wärmer ist sie, so die Hypothese.
es_37Q970SNZGLL5I60C13BEBXFSGW1S0	schwarz :: So ist es passiert.
es_37TD41K0AJM5SLGYSYSVV7G6ZRPCSY	weiß :: Weiß war die Farbe, die den geringsten Temperaturanstieg verursachte, und ist daher die am besten geeignete Farbe, um die Hundehütte zu streichen, damit der Hund nicht einer zu hohen Temperatur ausgesetzt wird.
es_37W3JXSD68LB25YC8VKLPNBA8R9WY9	weiß :: Da es sich nicht um eine dunkle Farbe handelt, trägt es dazu bei, die Hitze im Inneren des Zwingers zu reduzieren. Allerdings ist es wichtig, die Eigenschaften des Hundes zu berücksichtigen, wie pelzig er ist.
es_37WLF8U1WR3IOLUPDY6QILXMF3X6KS	weiß :: es wäre kühler, es wäre weniger heiß. grüße.
es_37ZHEEHM6YZVWN0NB2JJ7DGG2KG37L	Weiß :: Den Ergebnissen zufolge ist Weiß die Farbe, die am besten gegen Hitze von außen schützt und daher für das Dach des Hauses verwendet werden sollte.
es_384PI804XUELYTLIGIZB06E5MVS0SB	hellgrau :: Das helle Grau wäre am besten, da die beiden dunkleren bedeuten würden, dass bei der Lichtmenge im Sommer die Wärmemenge im Zwinger sehr hoch wäre, während im Winter, wenn es weniger Licht gibt, das weiße zu wenig wäre, um genug Licht zu liefern, um den Zwinger richtig zu heizen.
es_386PBUZZXHA5WMREIHCG6PF6QDSLJU	hellgrau :: Es gibt ein klassisches Haushaltsexperiment, bei dem eine Kerze in eine Schale mit ... Es gibt drei Phänomene, die im Glas auftreten, während die Kerze brennt: ... Das Wasser steigt also nach oben und füllt den Zwischenraum, der 1/5 des ursprünglichen Volumens beträgt. ... Wie im Experiment zu sehen ist, ändert sich der Druck nicht ...
es_38F5OAUN5PPAQV7MQN8LB7HQQQCH7R	weiß :: sieht heller aus
es_38SKSKU7R3A91B780ZRGUO06FXVLIA	Schwarz :: Kann die Umgebung in einer bestimmten Sichtweise dunkler machen
es_38YMOXR4MWC9JLO62CPT6WRH6AW6WI	schwarz :: Die schwarze Farbe zieht mehr Lichtteilchen (Photonen) an, was bedeutet, dass ihre thermische Anziehungskraft schneller zunimmt und ihr thermischer Gradient ebenfalls höher ist.
es_38YMOXR4MWC9JLO62CPT6WRH76YW63	weiß :: Die Farbe Weiß trägt dazu bei, die Temperatur im Haus zu senken. Um dies zu überprüfen, genügt ein Blick auf die Tabelle mit den Durchschnittstemperaturen.
es_392CY0QWG34D330NU7SZ87YVRD6I4M	hellgrau :: hellgrau 46
es_39ASUFLU6ZKSL0MBIZ4DK3X1SA6XEZ	weiß :: Weiß absorbiert keine Wärme und trägt daher dazu bei, den Raum kühler zu halten.
es_39JEC7537WELKDX2MTX06U0DRVXCVA	Dunkelgrau :: Dunkelgrau ist stabiler
es_39JEC7537WELKDX2MTX06U0DW6PVCC	weiß :: Ich mag weiß sehr gerne. Es ist eine sehr reine und schöne Farbe für die Seele und die Augen.
es_39KFRKBFIP83XWPAH9TB8TYO2Q3YOR	weiß :: Mit einer weiß gestrichenen Hundehütte ist der Hund an sonnigen Tagen weniger extremen Temperaturen ausgesetzt.
es_39LNWE0K4W9CK1U29DJHLBWPXTVUIZ	weiß :: Weiß wäre die ideale Farbe für die Hundehütte, da sie dem Experiment zufolge den geringsten Temperaturanstieg erfährt.
es_39LOEL67OUIZW156L7BPLDCBBFA38G	hellgrau :: es ist sehr offensichtlich, dass es auf drastische Weise beeinflusst werden kann und es ist alles üblich meine Meinung ist klar und wissenschaftlich es ist mein Süchtiger es ist wahr dieses Licht und seine Bestandteile
es_39LOEL67OUIZW156L7BPLDCBEE583H	weiß :: DIE FARBE VON BALNCO IST SEHR EFFEKTIV, WEIL SIE IM TEST 42,43 IST EINE SEHR ATTRAKTIVE KOMBINATION UND PRUBA 3 VON 41 IST AUCH GLANZ DES ERGEBNISSES, UND SEINE PERFEKTE FARBE VON DOG UND MESSUNG VON 42 IST SEHR FERTIG VON DOG.
es_39O5D9O87V5184VJ2JRUNZ8U1DLC3Z	Dunkelgrau :: Von allen im Experiment verwendeten Farben ist dies diejenige, die eine mittlere Temperatur aufweist, so dass sie sowohl für warme als auch für kalte Außentemperaturen geeignet ist.
es_39RP059MEJ6JKLBNU10E8EBIPS8BM1	weiß :: Je höher die Temperatur, desto größer ist das Unbehagen in der Umgebung.
es_39U1BHVTDN4IULXUO5MKC98YOWU3TB	weiß :: Weiß absorbiert das Licht nicht so stark wie die anderen Farben, sondern reflektiert es stärker.  Wenn das Licht nicht absorbiert wird, erwärmt es sich auch nicht so stark. Aus diesem Grund haben Experimente mit weißer Farbe die niedrigsten Temperaturen.
es_39ZSFO5CAA98FCE8RV4HXCBP358JUB	weiß :: Wenn Brandi und Jerry in einem warmen Klima leben, ist die Farbe Weiß am besten geeignet, da die Temperatur im Haus an sonnigen Tagen nicht so stark ansteigt und es etwas kühler bleibt. Wenn sie den Zwinger in einer dunklen Farbe streichen, kann der Zwinger im Sommer unerträglich werden. Wenn Brandi und Jerry in einem kälteren und weniger sonnigen Klima leben, wäre es besser, das Haus schwarz zu streichen, damit es im Winter an sonnigen Tagen eine etwas wärmere Innentemperatur haben kann.
es_3A0EX8ZRNA1JE201D4OP29YPUUFYBN	hellgrau :: Angenommen, ich beschließe, in meiner Küche, in der Nähe des Fensters, Sojasprossen anzubauen. Ich säe einige Sojabohnensamen in einen Topf mit Erde, stelle sie auf die Fensterbank und warte, bis sie keimen. Nach einigen Wochen keimt es jedoch nicht mehr. Warum? Nun... es stellte sich heraus, dass ich vergessen hatte, die Samen zu gießen.
es_3A4NIXBJ78CVXUXZLEP8MH7NW3DLMI	schwarz :: Das Haus wäre innen wärmer, wenn es schwarz wäre. Die Ergebnisse des Experiments unterstützen diese Schlussfolgerung, denn sie zeigen, dass die Lufttemperatur im Inneren des Glasbehälters umso höher ist, je dunkler die Farbe des Deckels ist.
es_3A4NIXBJ78CVXUXZLEP8MH7NYWSLML	weiß :: Das Experiment zeigt: Je heller die Farbe, desto weniger Wärme staut sich im Inneren. Daher ist die beste Farbe für das Dach der Hundehütte weiß. Die im Experiment erreichte Mindesttemperatur (41 °C) ist jedoch zu hoch, als dass ein Lebewesen sie über einen längeren Zeitraum aushalten könnte.
es_3A4TN5196MVG2C2IH4GWRT94JAAHC1	weiß :: Die am besten geeignete Farbe wäre weiß, weil es die Farbe ist, die die niedrigste Temperatur beibehält, die Verwendung der anderen Farben in dem Experiment würde das Haus sehr heiß machen.
es_3A9AA95ATYZNG8RRL71TMW5LFGUP5W	Weiß :: Dank des Experiments kann man feststellen, dass Weiß die beste Wahl ist, weil es nach 10 Minuten unter der Lampe weniger Wärme absorbiert als dunkle Farben.
es_3AMYWKA6YDZ1ECF4BQYJP2EV072O6O	weiß :: Während der heißen und sonnigen Jahreszeiten wäre die optimale Farbe weiß, denn nach den Ergebnissen des Experiments ist dies die Farbe, die am wenigsten Energie von der Lampe absorbiert. Der Hund wird sich im Sommer in der Hundehütte wohlfühlen.
es_3AMYWKA6YDZ1ECF4BQYJP2EV1YEO6J	schwarz :: Die schwarze Farbe maximiert die Innentemperatur und kann im Winter nützlich sein.
es_3AMYWKA6YDZ1ECF4BQYJP2EV4WX6OJ	weiß :: Die weiße Farbe ist die Farbe, die den besten Nutzen für den Zwinger bringt, da sie als hellste Farbe weniger Wärme absorbiert. Dunkle Farben absorbieren das Licht, was sich direkt auf die Temperatur auswirkt, während helle Farben, in diesem Fall weiß, das Licht reflektieren und weniger Wärme absorbieren.
es_3AQF3RZ55AV78Z2BCNFT285HBTY6FK	"hellgrau :: Es gibt ein klassisches Experiment für zu Hause, bei dem man eine Kerze in eine Schale mit etwas Wasser stellt und diese mit einem Glas abdeckt. Die Kerze verbraucht Sauerstoff, bis sie erlischt, und das Wasser fließt in das Glas, da der Druck dort stark gesunken ist. Es kommt immer heraus, es kommt sehr gut heraus und es ist sehr dankbar... Was nicht so klar ist, ist, was wirklich passiert und was der Grund für diese Druckschwankungen ist. Javier Fernández Panadero hat vor ein paar Tagen hier in Naukas darüber berichtet (siehe) und deutlich gemacht, dass die ""klassische"" Erklärung nicht die richtige ist."
es_3ATTHHXXWC1415OXEIU45IVTPQRXI1	weiß :: Die Temperatur ändert sich je nach Farbe, wenn Schwarz die Temperatur erhöht, verringert Weiß die Temperatur.
es_3AUQQEL7U761QL2MAD4GBTYCMX3V0P	weiß :: Die Ergebnisse zeigen, dass weiß die niedrigste Temperatur verursacht. Daher sollte Weiß verwendet werden.
es_3B1NLC6UG19LW5GB23KKQTWA316GPP	schwarz :: schwarz :: schwarz, weil es dann wärmer für den Hund ist
es_3B1NLC6UG19LW5GB23KKQTWA40TPGK	weiß :: Die Farbe weiß kann das Haus kühl machen, wenn es draußen sehr heiß ist, und der Hund wird nicht zu heiß.
es_3B837J3LDQ99YN5HAVIQK2FSTOZSRD	dunkelgrau :: Die Temperatur im Inneren des Behälters steigt.
es_3BC8WZX3V59XX854V6ILUSAW8KBRRG	weiß :: Weiß wäre die beste Farbe für die Hundehütte, weil sie nicht so viel Wärme und Licht absorbiert wie die anderen Farben, die im Experiment verwendet werden. Wenn der Zwinger weiß gestrichen ist, wird es im Inneren nicht so warm. In dem Versuch hatte die weiße Platte nur eine Durchschnittstemperatur von 42 Grad C, während die anderen eine höhere Durchschnittstemperatur als die weiße Platte hatten.
es_3BDCF01OGZ7VRBMD4HDJGCUU4CFLYT	weiß :: Die Temperatur steigt unabhängig von der Farbe an, aber weiß erhöht die Temperatur um weniger Grad. Das wäre für den Hund im Zwinger bei heißem Wetter angenehmer.
es_3BQU611VFRXLP8DW78IDCMA806999Q	weiß :: Bei einem weißen Anstrich werden die Sonnenstrahlen stärker reflektiert, so dass die Wärmeabsorption geringer ist, wie in der obigen Tabelle dargestellt.
es_3BQU611VFRXLP8DW78IDCMA8Y8K993	hellgrau :: wenn es Sommer ist, wird die Temperatur in der Hundehütte nicht so hoch sein. Wenn es Winter ist, kann er sich so etwas besser aufwärmen, als wenn er einen weißen Zwinger hätte. Ich betrachte Hellgrau als neutral.
es_3BWI6RSP7IMY6LGK0M0FQ4KDS7ZE7B	weiß :: Ich würde weiß wählen, da es weniger Energie absorbiert, was dazu beiträgt, dass die Temperatur im Inneren des Zwingers für den Hund kühler bleibt.
es_3BXQMRHWK1BYGKKTUSH9D436785UMA	weiß :: Weiß wäre die am besten geeignete Farbe, da sie die Temperatur kühler hält, so dass die Atmosphäre nicht zu heiß wird.
es_3C5W7UE9CH3QXOEOZXSWXB2A1FKMX6	weiß :: Weiße Farben senken die Temperatur des Hauses um zehn bis zwölf Grad, daher ist es besser, weiße oder hellgraue Farben zu verwenden.
es_3CCZ6YKWR9W2OLBK4I5W0656BM095U	weiß :: Die Ergebnisse des Experiments zeigen, dass die weiße Farbe weniger Energie speichert. Daher wäre die weiße Farbe für den Schuppen besser geeignet.
es_3CFJTT4SXV3AMQI6W5Q6BJI5JKK7IU	weiß :: Weiß ist die beste Farbe, um sicherzustellen, dass sich das Innere des Hauses nicht zu sehr aufheizt. Die durchschnittliche Temperatur der weißen Farbe war die niedrigste in dem Versuch (42 °C), und je dunkler die Farbe, desto höher die Temperatur.
es_3CFVK00FWNYT8RC7YYIRXLA144G6LB	hellgrau :: Hellgrau ist eine neutrale Farbe, daher liegt die Temperatur auf einem durchschnittlichen Niveau.
es_3CFVK00FWNYT8RC7YYIRXLA146UL68	weiß :: Weiß ist die beste Farbe, weil sie die niedrigste Temperatur im Inneren der Hundehütte aufrechterhält.  Wenn die Hundehütte vorübergehend draußen in der Sonne steht, ist die Gefahr, dass der Hund erstickt, geringer, da die durchschnittliche Temperatur in einer weißen Hundehütte 42 Grad Celsius beträgt und damit die niedrigste aller Farben ist. Wenn es jedoch draußen Herbst oder Winter ist, dann ist es besser, Schwarz zu wählen, da es die Hundehütte in der Sonne besser wärmt.
es_3CN4LGXD5Z1ZT3FSYPE2UVSJKLX4YO	weiß :: Die weiße Farbe absorbiert keine Wärme und erhöht die Temperatur des Zwingers nicht. Im Sommer kann sich der Hund im Zwinger aufhalten, ohne dass ihm heiß wird.
es_3CPLWGV3MQC6EAHQ8I1IUN5S0XIN9U	Dunkelgrau :: Durch die konzentrierte Hitze im Inneren des Behälters nimmt die Farbe, die sich im Inneren des Behälters auszubreiten beginnt, von Schwarz zu einer gedämpfteren Farbe ab.
es_3D8YOU6S9GXWRHZ17CASO86KHXHU65	weiß :: Weiß wäre die Farbe, die die Temperatur senken würde, damit sie den Durchschnitt anzeigt und der Hund sich in einer besseren Situation befindet.
es_3DBQWDE4Y8BNDNFE5SO1I70QG6JN5Z	Hellgrau :: Ich denke, das würde den Kabinen einen helleren Ton verleihen.
es_3DBQWDE4Y8BNDNFE5SO1I70QLQW5N3	blanco :: Beschreiben Sie Como sehen Farbe Podologie beeinflussen Al Innen DE la Kassette. USA sol resultants Del experiments para apiary too description.
es_3DI28L7YXCRKVZ1IB6J6PUT0RKTE18	Schwarz :: Da es die Farbe ist, die die meiste Temperatur absorbiert, zeigt das Thermometer an, dass die Temperatur im Inneren des Hauses höher ist als bei den anderen exponierten Farben.
es_3DL65MZB8FS4I2BGR38Q6QCRSS8CE3	hellgrau :: Je heller die Farbe, desto niedriger ist die Temperatur im Inneren des Zwingers. Ich habe mich für Hellgrau entschieden, aber ich hätte auch Dunkelgrau wählen können, da jede dieser Farben sowohl für kalte als auch für warme Klimazonen geeignet ist. Weiß würde den Zwinger in einem kalten Klima kälter machen, aber in einem warmen Klima würde es die Temperatur im Zwinger angenehmer machen, und umgekehrt würde der Zwinger in einem warmen Klima sehr heiß sein, aber in einem kalten Klima könnte er etwas Wärme spenden.
es_3DPNQGW4LNSXAJ5MS6JAB48QJFG466	schwarz :: Könnte die Temperatur im Haus erhöhen, da dunkle Farben die Wärme verstärken.
es_3DR23U6WE7RL4JDRDP3GV0CVNAUET9	weiß :: Helle Farben haben im Gegensatz zu dunklen Farben größere Schwierigkeiten, Lichtwellen zu absorbieren, so dass es ihnen schwerer fällt, diese Energie in Form von Wärme zu speichern. Die ideale Farbe für die Hundehütte ist daher weiß, da sie am hellsten und am besten für die oben genannten Zwecke geeignet ist.
es_3DUZQ9U6SO11RUMYJFN0LZ4VDRCVS2	weiß :: Die Farbe weiß hält die Temperatur in der Hundehütte kühler als ein dunklerer Anstrich. Weiß wäre ideal, um den Hund vor Überhitzung zu schützen und ihn im Zwinger bequem unterzubringen.
es_3DUZQ9U6SO11RUMYJFN0LZ4VDUNSVG	weiß :: Weiß ist die am besten geeignete Farbe, um den Zwinger zu streichen, da es die Farbe ist, die dazu beiträgt, dass die Temperatur im Zwinger nicht zu hoch wird. S
es_3DY4FPOOA31PQFML4QNVVPZZRRARVV	Schwarz :: Bei allen Tests war die Farbe Schwarz im Vergleich zu den anderen Farben am wärmsten.
es_3DYGAII7PNLC9UAP5ZPWK70C9OZQPE	weiß :: Nach dem Experiment wäre weiß die am besten geeignete Farbe für das Haus, da sie eine gute Temperatur hält.
es_3DYGAII7PNLC9UAP5ZPWK70CA03PQ6	hellgrau :: Wenn wir die klimatischen Bedingungen nicht kennen, wissen wir nicht, ob wir eine höhere oder niedrigere Temperatur in den Zwinger bringen wollen. Wir sollten im Sommer eine weiße Hundehütte und im Winter eine schwarze Hundehütte haben. Angenommen, wir könnten nur eines bauen und das in einem kalten Klima im Winter und in einem warmen im Sommer. Ich würde mich für ein mittleres Grau entscheiden, obwohl ich hier in Ermangelung einer anderen Möglichkeit hellgrau gewählt habe. Das helle Grau würde den Schuppen ein wenig wärmen, aber nicht zu sehr.
es_3DYGAII7PNLC9UAP5ZPWK70CG6UQPG	hellgrau :: Nach dieser Tabelle, die vier verschiedenen Tabellen schwarz, dunkelgrau, hellgrau weiß Meine Wahl ist hellgrau, weil es perfekt für Hausmalerei ist.
es_3E13VNJ1NP8WB4347P9XA9RSFQ9I1G	weiß :: Die Verwendung eines weißen Deckels wäre besser als die der anderen drei Farben, da Weiß die Temperatur nur auf durchschnittlich 42 Grad Celsius anhebt.  Die anderen Farben erhöhen die Lufttemperatur im Inneren des Behälters und wären für Ihren Hund gefährlich.
es_3E13VNJ1NP8WB4347P9XA9RSIU31I4	Weiß :: Die Lampe erzeugt Infrarotwärme, die der Wärme der Sonnenstrahlen ähnelt. Helle Oberflächen reflektieren die Infrarotwärme, während dunkle Oberflächen sie absorbieren. Eine dunkle Kiste würde sich tagsüber sehr stark aufheizen; eine helle Kiste ist viel angenehmer, weil die Temperatur konstanter ist.
es_3E13VNJ1NP8WB4347P9XA9RSJKTI1S	weiß :: Diese Farbe für den Anstrich der Hundehütte erzeugt die geringstmögliche innere Erwärmung des Zwingers gegenüber einer äußeren Wärmequelle (praktisches Beispiel: Sonne).
es_3E1QT0TDFRMEM4NP6AICPJE0TWG8IR	weiß :: Da dies die hellste Farbe ist, und nachdem man die Ergebnisse des Experiments gesehen hat, kann man leicht zu dem Schluss kommen, dass dies die richtige Farbe für das Gerätehaus ist, da sie die Luft im Inneren kühler hält als die anderen Optionen.
es_3E1QT0TDFRMEM4NP6AICPJE0YUF8IR	blanco :: Blanco
es_3E337GFOLBLLTK4YMO7SM4RF4Z8GNN	weiß :: Gewählte Farbe: weißAus den Ergebnissen des Experiments lässt sich schließen, dass die Farben durch die Temperatur beeinflusst werden können: \Die Farbe Weiß wurde ausgewählt, weil sie die niedrigste Temperatur aufweist und dem Hund bei heißem Wetter ein angenehmes Gefühl vermittelt. Je nach gewünschter Temperatur auf der Skala von kühler bis wärmer werden die folgenden Optionen angeboten: Option 1: Weiß Option 2: Hellgrau Option 3: Dunkelgrau Option 4: Schwarz
es_3E337GFOLBLLTK4YMO7SM4RFBWPNGC	weiß :: als diese Farbe die Ergebnisse des Experiments 43 weiß hellgrau 44 45
es_3E4GGUZ1TA4U6KBOQWUNS8GA03BK2G	weiß :: Die Hundehütte wird drinnen kühler sein, wenn die Sonne scheint und es draußen heiß ist. Die weiße Wärmefarbe reflektiert die Sonnenenergie. Gut gemacht, Brandi und Jerry!
es_3E4GGUZ1TA4U6KBOQWUNS8GA1LBK2H	hellgrau :: Da es sich um eine Zwischenfarbe handelt, kann sie sowohl im Sommer als auch im Winter die Wärme an kalten Tagen besser speichern und an wärmeren Tagen eine akzeptable Temperatur aufrechterhalten.
es_3E4GGUZ1TA4U6KBOQWUNS8GA28OK25	weiß :: Weiß ist die Farbe, die am meisten Energie abweist und daher am wenigsten Wärme absorbiert. Wenn wir ein weißes Dach anbringen, wird die Wärme in geringerem Maße an das Innere des Hauses weitergegeben und bleibt auf einer niedrigeren Temperatur.
es_3E7TUJ2EGEZXSYQDJONFYITYMS1D9L	weiß :: Weiß ist die empfohlene Farbe, da sie weniger Temperatur absorbiert und das Gebäude kühler hält als andere Farben.
es_3EG49X351WPO8LTWCHLF8F5ODRWX6O	"weiß :: Eine Hypothese ist nicht unbedingt richtig. Vielmehr handelt es sich um eine ""beste Vermutung"", und die Wissenschaftler müssen prüfen, ob sie tatsächlich richtig ist. Wissenschaftler testen Hypothesen, indem sie Vorhersagen treffen: Wenn die Hypothese Text YYY richtig ist, dann sollte Text YYY wahr sein. Anschließend führen sie Experimente oder Beobachtungen durch, um festzustellen, ob die Vorhersagen richtig sind. Wenn ja, ist die Hypothese bestätigt. Wenn nicht, ist es an der Zeit, neue Hypothesen aufzustellen."
es_3EJJQNKU9TIK8ER1Z16RGO8QRWBRHT	weiß :: die Farbe könnte das Innere des Schuppens beeinflussen
es_3F0BG9B9MR0WCQXB0NC9X7CT9WEY79	weiß :: Weiß ist die Farbe, die aufgrund ihrer Zusammensetzung am wenigsten Energie absorbiert, da sie sich aus allen Farben zusammensetzt. Für die Hundehütte von Brandi und Jerry ist die ideale Farbe die Bank, da sie die niedrigste Temperatur hatte und die Abweichung zwischen den Tests 1-2 Grad betrug.
es_3F6KKYWMNDEIH0U7KY6KGJOITMYNDM	weiß :: Die Farbe weiß würde dazu beitragen, dass der Hund im Inneren des Zwingers in einem temperaturgeregelten Raum gehalten wird, der der Temperatur außerhalb des Zwingers näher kommt.
es_3FE7TXL1LK0GHN9J31EKOUSJY8Z2QJ	weiß :: Nach den Ergebnissen des Experiments ist die beste Farbe für die Hundehütte weiß. Es ist die Farbe, die am wenigsten Temperatur absorbiert, also wäre es die ideale Farbe für Brandi und Jerrys Hund.
es_3FFJ6VRIL31W4FIMB65XW48IAXV0IL	hellgrau :: Die hellgraue Farbe würde dazu beitragen, die Temperatur ein wenig anzuheben, und der Hund würde sich nicht so kalt fühlen. Die Verwendung einer dunkleren Farbe wäre nachteilig, weil der Hund sich zu sehr erhitzt fühlen und aus dem Haus gehen würde.
es_3FQ5JJ512N1QV60HCFS7KWJ8ATLNKI	weiß :: Die Lufttemperatur mit der weißen Farbe war mit 42 C am niedrigsten. Der Zwinger muss weiß sein, damit der Hund nicht unter hohen Temperaturen leidet. Je dunkler die Farbe, desto schlimmer ist es für den Hund.
es_3FQ5JJ512N1QV60HCFS7KWJ8AVMNKN	weiß :: Ich würde weiß wählen, weil die Temperatur langsamer ansteigt als bei den dunkleren Farben. Dies ist wichtig, da der Hund aufgrund seiner vielen Haare auch niedrigere Temperaturen benötigt. Aus dem Experiment geht hervor, dass Weiß eine niedrigere Temperatur hat.
es_3FTF2T8WLTVW14Q40JS5Q6IJSETW9A	weiß :: weiß ist wacher als die anderen.
es_3FTF2T8WLTVW14Q40JS5Q6IJUDA9W4	Weiß :: Da Weiß die Farbe ist, die am wenigsten Energie absorbiert, heizt sich das Innere des Gebäudes nicht so stark auf wie bei anderen Farben.
es_3FTF2T8WLTVW14Q40JS5Q6IJXRLW9X	weiß :: Die weiße Farbe reflektiert die Sonnenstrahlen, wodurch die Temperatur des Behälters niedriger ist als bei jeder anderen Farbe. Die Ergebnisse des Experiments bestätigen dies, denn sie zeigen, dass die Temperaturen im Inneren des Glasgefäßes bei Verwendung des weißen Deckels niedriger sind.
es_3FTYUGLFSWYERBO1GYAYM2OW01L5DZ	schwarz :: Nach den Ergebnissen des Experiments ist ein schwarzes Haus wärmer als ein weißes Haus, weil dunklere Farben mehr Energie absorbieren und die Temperatur im Haus erhöhen.
es_3G0WWMR1UXXC69YCPKC4GIVHB7RQN9	hellgrau :: Die hellgraue Farbe wäre die beste Wahl, da sie laut der Ergebnistabelle in der Mitte der Extreme liegt, wodurch die externen Temperaturschwankungen aufgrund der jahreszeitlichen Veränderungen nicht so extrem wären.
es_3GDTJDAPVWO0INDGRPG4HCLHALQM87	grau claro :: Blanco
es_3GDTJDAPVWO0INDGRPG4HCLHI4R8M4	dunkelgrau :: GEIS DARK GEIS
es_3H0W84IWBMF8O40Z90YLVLBDRWXREF	Dunkelgrau :: Eine wichtige Angabe für dieses Experiment ist das Klima des Gebiets, in dem die Hütte aufgestellt wird. Ich denke, ich könnte mich für Dunkelgrau entscheiden, weil die Temperatur stabiler ist, und für Schwarz, wenn es zum Beispiel im Sommer zu heiß ist, wäre es zu ungemütlich zum Ausruhen.
es_3H7XDTSHKE4BGEDCEPYFIN461XDGWR	weiß :: Die Farbe wirkt sich auf die Temperatur aus, die das Gebäude im Inneren haben wird. Aus den gegebenen Daten geht hervor, dass die Farbe Weiß im Vergleich zu Schwarz am wenigsten Energie verbraucht.
es_3H7Z272LX9K1IXUCDUH03L1I31ILPW	hellgrau :: Ich halte dies für einen Zwischenstand, da andere Faktoren nicht berücksichtigt werden, wie der Standort des Schuppens (im Freien oder nicht), ob das Klima normalerweise heiß oder feucht ist usw..
es_3H7Z272LX9K1IXUCDUH03L1IZ8IPLA	weiß :: Weiß ist die Farbe, die die Temperatur im Zwinger an heißen Tagen am wenigsten ansteigen lässt (18°C über der Ausgangstemperatur, im Vergleich zu fast 30°C bei schwarz). Im Winter würde jede der anderen Farben, die in dem Versuch verwendet wurden, zu einer gemäßigteren Temperatur im Zwinger beitragen, aber angesichts der Eigenschaften der Hunde und ihres Fells ist es zweckmäßiger, im Sommer darauf zu achten, dass die Temperatur nicht zu stark ansteigt.
es_3HFNH7HEMJR6WHHQ2GZ9QYMKCO7QGR	schwarz :: Schwarz ist die beste Farbe für das Innere des Zwingers, denn Schwarz ist die Farbe, die die Wärme der Luft am besten anzieht. Deshalb könnte der Hund besser dran sein. Die Daten beweisen es, denn der schwarze Zwinger hat eine Temperatur von 54 Grad, mehr oder weniger.
es_3HHRAGRYXAIOWVH29X1V9C5XSIG9OC	Weiß :: Den Ergebnissen zufolge ist Weiß die Farbe, die am wenigsten Wärme von den Sonnenstrahlen absorbiert, so dass die Temperatur im Inneren der Hundehütte nicht so hoch ist wie bei einem Anstrich in anderen Farben.
es_3HMIGG0U4NJ0C42UAS4FB78OKHJ8Y7	weiß :: Wenn Sie ein Haus mit niedrigeren Temperaturen wünschen (vor allem im Sommer), sollte die Farbe weiß sein, da sie die Wärme nicht so stark absorbiert wie dunklere Farben.
es_3HMVI3QICL5I14I9B7V0WXLGCN51Y2	Dunkelgrau :: Dunkelgrau ist die mittlere Farbe, die am besten reagieren würde als eine wirklich gute Option, um das Haus zu machen, die Temperatur wäre in gutem Zustand, das Haus würde gut aussehen und es würde ein wirklich wunderbares Haus zu leben darstellen.
es_3HOSI13XH119VO3UV4SHKECOH91DDJ	weiß :: NACH DIESER TABELLE WÄHLEN BRANDI UND JERRY DIE VIER FARBEN IHRER WAHL, EINE IST SCHWARZ, DUNKELGRAU, HELLGRAU, BALNCO. ICH DENKE, DIE PERFEKTE WEISSE FARBE, WEIL TEST 1 UND TEST 2 IST MISCHEN 42 UND 43 UND TEST 3 UND EINE HÄLFTE IST 41 UND 42 SO JEDE KOMBINATION IST SEHR GUT UND WEISS IST PERFEKT FÜR DEN HUND.
es_3HPZF4IVNO62O7S7R4KKDT47B3PCYT	Schwarz :: Nach den Ergebnissen des Experiments ist Schwarz die Farbe, die die Temperatur des Hauses am stärksten erhöhen würde. Das liegt daran, dass Schwarz das Licht absorbiert, anstatt es zu reflektieren, so dass es mehr Energie aufnimmt. Diese Farbe ist ideal für Häuser, die für kalte Gebiete bestimmt sind.
es_3HPZF4IVNO62O7S7R4KKDT47C7AYC9	hellgrau :: die Temperatur in dunkelgrau hat sich überhaupt nicht verändert
es_3HRMW88U183I0Y8DWL3POXFZUY30MC	weiß :: Weiß ist die Farbe mit der niedrigsten Temperatur in allen Tests. Für eine Hundehütte wäre es die beste Farbe, um den Hund vor Hitze zu schützen.
es_3HVVDCPGTG5JAOUIDQFA234BXTCYTR	schwarz :: Die Farbe schwarz gibt dem Hund ein wärmeres Zuhause.
es_3HYA4D452TWJQYJAPL3QCVO5R3T2FM	hellgrau :: Hellgrau
es_3HYA4D452TWJQYJAPL3QCVO5R4EF2M	weiß :: Die beste Farbe ist weiß, weil sie die Luft im Haus kühler hält. Aus den Versuchsergebnissen ist ersichtlich, dass der weiße Deckel die Temperatur des Behälters niedriger hielt als die anderen Deckel.
es_3I2PTA7R3V7BY3D9S7KOOQEDFBUKQ2	Hellgrau :: Es kann die Inneneinrichtung beeinflussen, indem es sie lebendiger, moderner und attraktiver aussehen lässt.
es_3I33IC7ZWHFOU722E5HYYUDEZK3A23	weiß :: DER INNENBEREICH DES STANDES WIRD KÜHLER SEIN. WIE SIE AUS DEN ERGEBNISSEN ERSEHEN KÖNNEN, LAG DIE LUFTTEMPERATUR IM GLASGEFÄSS MIT DEM WEISSEN DECKEL BEI 42, 43, 41 UND 42. BEI ALLEN VIER TESTS WAR DIES DAS NIEDRIGSTE ERGEBNIS. DAS IST GUT. UND BEDEUTET, DASS DIE WEISSE FARBE DIE KÜHLSTE FARBE IST.
es_3I3WADAZ9SH5V8FQ67OEXW0V8YN5OX	weiß :: weil das weiße Pitura weniger heizt und die Temperatur niedriger ist.
es_3IGI0VL649X9LXLWA7K0RD0HUZ1NOA	schwarz :: Licht ist nichts anderes als elektromagnetische Strahlung und als solche Träger von Energie. Helle Farben, wie z. B. Weiß, reflektieren die Strahlung am stärksten und absorbieren daher sehr wenig oder strahlen die absorbierte Energie sehr schnell ab. Dunkle Farben, wie Schwarz oder Dunkelgrau, absorbieren die meiste Strahlung. Sie sind in der Lage, viel Energie dieser Art zu absorbieren und sie dann langsam wieder abzustrahlen. Wenn wir also dunkle Farben für die Hundehütte verwenden, absorbieren sie tagsüber die Sonneneinstrahlung und versorgen unseren Hund nachts über einen längeren Zeitraum mit Wärme. Je dunkler der Deckel ist, desto höher ist die Temperatur im Inneren des Zwingers, wenn das Licht ausgeschaltet ist, wie aus den Ergebnissen der Tabelle hervorgeht, und das Gleiche gilt, wenn die Sonneneinstrahlung bei Einbruch der Dunkelheit ausfällt. Die Temperatur wird höher sein und die Wärme im Haus wird länger gehalten.
es_3IHR8NYAM9E5KPNR72IJH4Z7FB9P4J	schwarz :: Die Farbe Schwarz wirkt sich auf den Schuppen aus und macht das Licht kühler.
es_3II4UPYCOLK3KX7Z0QY1KDJNWT8QDP	hellgrau :: Der Temperaturunterschied zwischen weiß und hellgrau ist sehr gering, und der Hund würde die graue Farbe mehr genießen, da er nicht schwarz-weiß sieht.
es_3IJXV6UZ1ZWK492L5JOCG095LP1IRE	weiß :: Die Farbe weiß garantiert eine niedrigere Temperatur im Inneren der Hundehütte, so die Ergebnisse der Versuche. Graue Farben würden einen leichten Anstieg und Schwarz die höchste Temperatur verursachen.
es_3IOEN3P9S9WGIK835O08D61N9XV16L	schwarz :: Je dunkler die Farbe, desto höher ist die Energieabsorption und desto schwarz ist das Ergebnis.
es_3IQ1VMJRYVXZURN1ZEWD8HLS1139A2	weiß :: Aus den Ergebnissen geht hervor, dass die weiße Farbe diejenige ist, bei der die Temperatur nicht so stark ansteigt wie bei den anderen Farbkappen.
es_3IRIK4HM3CX05NI1LLPSU2KEFFEC6M	weiß :: Die Weiße ist diejenige mit der niedrigsten Temperatur in einer der Studien im Vergleich zu den anderen Experimenten.
es_3IXQG4FA2VB4D1ST5SW93S5YIBZ9BR	weiß :: Dies ist die am besten geeignete Farbe, da sie den Hund nicht überhitzt, da Weiß die Temperatur nicht so stark erhöht wie Schwarz oder dunklere Farben. Natürlich sollte auch die Außentemperatur berücksichtigt werden. An sehr kalten Orten ist es am besten, schwarz zu verwenden, und an heißen Orten ist es am besten, weiß zu verwenden. Mit freundlichen Grüßen.
es_3J88R45B2IBWIRB1RDKOEFW56MRPX5	schwarz :: Wenn Sie ein Haus mit einem schwarzen Dach bauen, wird das Haus wärmer, weil das Dach mehr Wärme absorbiert.
es_3J88R45B2IBWIRB1RDKOEFW57N7PXO	weiß :: Nach dem Experiment ist weiß die Farbe, die die geringste Wärmeausbreitung hat. Eine andere Farbe wäre zu heiß für den Hund
es_3JBT3HLQFAFLNMBGSV89B0CGEKSZPB	dunkelgrau :: Diese Farbe ergab immer 48, so dass die Temperatur des Gebäudes so gesteuert werden kann, dass sie nicht schwankt.
es_3JJVG1YBEDALCEQH22JSRC0WWFPB5B	weiß :: Je dunkler die Farbe, desto mehr Energie absorbiert sie und desto mehr Wärme erzeugt sie. Weiß wäre also die beste Wahl.
es_3JPSL1DZ5UCKJTRV0OFIQIGC6JTNAA	weiß :: Je heller die Farbe des Hauses ist, desto weniger steigt die Lufttemperatur im Inneren des Hauses, da helle Farben weniger Energie absorbieren.
es_3JV9LGBJWVR3B54AN3751TRKXB9OGD	weiß :: die farbe weiß hält die temperatur in der hundehütte niedrig, da der hund aufgrund seiner körperwärme einen kühlen ort braucht, da die hütte geschlossen ist. weiß hält die temperatur niedrig und der hund wird nicht so heiß.
es_3JWH6J9I9UQP23WN62FELT0IP4SBNE	Weiß :: Die Verwendung von Weiß führt zu einer niedrigeren Temperatur im Vergleich zu anderen Farben und ist für den Hund angenehmer.
es_3K4J6M3CXG6E91A9DK2N0Y7F47OAG5	weiß :: Wenn man die Ergebnisse des Experiments betrachtet, könnte man annehmen, dass die im Experiment nachgewiesenen Fakten auch für die Hundehütte gelten. Wenn die Hundehütte mit einer dunklen Farbe gestrichen wird, steigt die Temperatur im Inneren des Zwingers an, wie im Experiment gezeigt, während eine hellere Farbe, z. B. weiß, die Temperatur der Luft im Inneren des Zwingers senken würde.
es_3KGTPGBS6ZY89GG0KAYPYVP81W8U2P	weiß :: Weiß, weil es die Farbe ist, die am wenigsten Wärme anzieht, denn je dunkler die Farbe ist, desto mehr Wärme absorbiert sie.
es_3KJYX6QCMBO8SR38WLEMTYD8HF1VJ2	Weiß :: Da Weiß eine helle Farbe ist, absorbiert sie nicht so viel Energie. Laut Datentabelle hat Weiß die niedrigsten Temperaturen und ist daher die günstigste Farbe.
es_3KMS4QQVK43E7EN0ER9UCRAZ92TFKY	"schwarz :: Der Deckel ist schwarz, daher wird die Farbe höher sein. Im Abschnitt ""Daten"" ist die Beziehung zwischen Temperatur und Farbe aufgeführt."
es_3KRVW3HTZPYI17SP5NM9Y3LIM4CSM6	Weiß :: Da Weiß die hellste Farbe ist, absorbiert es weniger Energie und es entsteht weniger Wärme im Gebäude.
es_3KWTYT0872GXPNCTTF8M5FW1FHM5LY	dunkelgrau :: dunkelgrau
es_3L0KT67Y8GTIVOH3OQAKSY8PVBKSYK	weiß :: Weiß ist die Farbe, die die Wärmekonzentration am besten isoliert, was optimal für warme Tage und/oder Nächte ist. Im Winter können Sie sich für eine andere Option als Farbe entscheiden, die als Isolierung und Kälteschutz verwendet wird.
es_3L0KT67Y8GTIVOH3OQAKSY8PZV2YSG	weiß :: Weil die Farbe Weiß Energie spendet und dem Haus eine ästhetische Form verleiht.
es_3L2IS5HSFCV4Y25T6TW9QJS6DT8NUN	weiß :: Wenn Sie weiß wählen, bleibt die Temperatur stabil.
es_3LEIZ60CDLC0VZV9B6CCPAC19DIZ9I	weiß :: Den Daten aus Brandis und Jerrys Experiment zufolge erhöhte der weiße Deckel die Temperatur im Inneren des Zwingers am wenigsten. Daher wäre ein weißes Dach (und weiße Wände) für eine Hundehütte am besten geeignet, um den Komfort des Tieres zu gewährleisten. Das Konzept sagt jedoch nichts darüber aus, unter welchen Bedingungen der Zwinger genutzt werden soll. In einem Gebiet mit niedrigen Temperaturen (z. B. Alaska) könnte ein Zwinger mit einem dunklen Dach dazu beitragen, dass die Temperatur für das Tier angemessener ist.
es_3LJ7UR74RJQ5H4BERN5RDFUCFN4N4Z	schwarz :: schwarz wäre besser
es_3LO69W1SU5QV5K1DABRD9CNQ3DELGI	weiß :: Das Ergebnis des Experiments zeigt: Je dunkler die Farbe der Oberfläche, desto wärmer ist es im Inneren, während das Objekt Licht empfängt. Ich habe mich entschieden, die Zwinger weiß zu streichen, damit es im Inneren nicht zu warm für meinen Hund wird.
es_3LRKMWOKB7UPVFAAQ\nFN4N5I92ZI	weiß :: Weiß weist das Sonnenlicht und damit die Wärme ab.
es_3LRKMWOKB7UPVFAAQ\nFN4N7SB2Z6	schwarz :: Die im Rahmen des Experiments durchgeführten Tests bestätigen die Hypothese von Brandi und Jerri: Die Temperatur des Behälters war umso höher, je dunkler die Farbe des neben der Wärmequelle angebrachten Deckels war. So absorbiert die schwarze Farbe, die am dunkelsten ist, mehr Energie und kann die Wärme, die die Hundehütte z. B. durch Sonneneinstrahlung erhält, besser speichern.
es_3LRLIPTPESMJBN6S3BN2YQZ8BVQKAH	Weiß :: Weiß ist die beste Farbe, da die Wärme von der Quelle reflektiert wird und nur ein geringer Teil der Wärme ins Innere gelangt. Die Ergebnisse des Experiments zeigen, dass die weiße Farbe die niedrigste Temperatur im Inneren des Gefäßes hat und der Hund sich im Vergleich zu anderen Farben wohl fühlt.
es_3LUY3GC631D23C5A90GQKGJH4R47PG	dunkelgrau :: Die dunkelgraue Farbe hält die Temperatur konstant.
es_3LWJHTCVCEZ0IHLVRWTR8DM8FWYFQM	dunkelgrau :: Mit der dunkelgrauen Farbe ist die Temperatur weder zu heiß noch zu kalt.
es_3M68NM076JK4BP7K3IFNJXJ0AVAR6P	weiß :: Weiß gibt weniger Wärme an das Haus ab, da es die Farbe ist, die weniger Wärmeenergie absorbiert.
es_3M68NM076JK4BP7K3IFNJXJ0AVM6RG	weiß :: WEISSE FARBE REFLUXIERT LICHT, DARUM HEIZT SIE WENIGER. JE DUNKLER DIE FARBE IST, DESTO MEHR LICHT ZIEHT SIE AN UND DESTO MEHR WÄRME KONZENTRIERT SIE SICH.
es_3M81GAB8A2WA509FMU7VPNVNUKCQBN	weiß :: Die weiße Farbe würde stärker reflektieren und somit einen Teil des Sonnenlichts während des Tages abhalten, wodurch die Temperatur im Inneren des Gebäudes niedriger wäre.
es_3MHW492WW2QYTZ9TZIRE9Q5PL47MVY	weiß :: Je heller die Farbe, desto niedriger ist die Temperatur und desto wohler fühlt sich der Hund.
es_3MMN5BL1W1HEHQ7AF8L8QVD615V3MC	weiß :: Durch die Wahl von weiß sollte die Hundehütte nicht so warm sein.
es_3MMN5BL1W1HEHQ7AF8L8QVD6USO3M8	hellgrau :: Hellgrau ist die beste Farbe für den Zwinger, da sie weder zu niedrig noch zu hoch ist und ihm hilft, sich an unterschiedliche Außentemperaturen anzupassen.
es_3MMN5BL1W1HEHQ7AF8L8QVD6WO1M3Y	dunkelgrau :: Auf keinen Fall, da es die Temperatur im Inneren der Hundehütte nicht beeinträchtigt.
es_3MTMREQS4XVA6N09SP65M1T3Z4CWA7	schwarz :: Schwarz wird je nach Ergebnis wärmer.
es_3MX2NQ3YCB7SPHTI7YBAG9ROF0TX5M	weiß :: Ich würde weiß wählen, damit der Hund nicht überhitzt. weiß ist die Farbe, die die Temperatur am wenigsten erhöht, sie kann sogar isolieren, also wäre es eine gute Wahl, die oben genannte Farbe zu wählen.
es_3N1FSUEFL7DWVSK12TROHAIIZA64DI	weiß :: Den Versuchsergebnissen zufolge blieb die Temperatur im Inneren des Behälters niedriger, wenn der weiße Deckel verwendet wurde. Sie haben also gezeigt, dass dunkle Farben tatsächlich mehr Wärme speichern und helle Farben weniger Wärme speichern. Wenn Sie für die Hundehütte Weiß verwenden, bleibt die Innentemperatur kühler als bei einer dunkleren Farbe.
es_3N8OEVH1FT3R3IL8BMKD620MRHUOO1	weiß :: weich
es_3NG53N1RLXW63QATJ58WYGFCGJH8PS	schwarz :: Schwarz hat die höchste Temperatur in den Ergebnissen des Experiments.
es_3NG53N1RLXW63QATJ58WYGFCGMM8P3	weiß :: Dunkle Farben absorbieren mehr Licht und sind für den Hund wärmer.
es_3NKQQ8O390IVCQEGHZI6UEGCYKMDU0	weiß :: Der Zwinger bleibt kühler, weil Weiß die Farbe ist, die die Temperatur im Inneren des Glasbehälters am wenigsten ansteigen lässt. Wenn sie weiß verwenden, wird die Hundehütte viel kühler sein, wenn die Lampe eingeschaltet ist (wenn es eine Lampe im Haus gibt) oder einfach im Sonnenlicht. Wie aus den Ergebnissen hervorgeht, sind die beiden Farben mit den geringsten Temperaturschwankungen Hellgrau und Weiß. Der Unterschied zwischen Weiß und Hellgrau beträgt zwar nur wenige Grad Celsius, aber im Interesse der Effizienz und der maximalen Ausnutzung der niedrigen Temperatur wäre es am besten, Weiß zu verwenden. \Aber es wäre auch ideal, schwarz zu verwenden, wenn der Hund in einer sehr kalten Umgebung lebt, in der die Temperaturen nachts oder sogar tagsüber sinken, da die schwarze Farbe dazu beiträgt, die Wärme einer Glühbirne im Haus zu erhalten.
es_3NKQQ8O390IVCQEGHZI6UEGCZ25UD1	schwarz :: 1/ setzen Sie das schwarze Glasgefäß mit dem schwarzen Glasgefäß mit dem angebrachten Filter auf 2/ stellen Sie sicher, dass die Anfangstemperatur im Inneren des Gefäßes 24°C beträgt 3/ stellen Sie die Lampe in einem Abstand von einigen Zentimetern vom Deckel auf und schalten Sie sie ein 4/ messen Sie nach 10 Minuten die Temperatur der Luft im Inneren des Glasgefäßes und setzen Sie es zur Prüfung auf
es_3NKQQ8O390IVCQEGHZI6UEGCZ27UD3	weiß :: Je heller die Farbe des Hauses ist, desto geringer ist der Temperaturunterschied im Inneren des Hauses.
es_3NPI0JQDAQIP1A2HM3JRPCBZTRGPT1	hellgrau :: Hellgrau wäre eine gute Farbe, da sie den Stall weder zu heiß noch zu kalt macht. Dieses Experiment ist jedoch nur ein Hinweis darauf, wie es in einem Stall aussehen könnte, da es nicht 10 Minuten lang unter einer Lampe stehen wird. Dennoch wäre eine Zwischenfarbe meiner Meinung nach am besten geeignet.
es_3NPI0JQDAQIP1A2HM3JRPCBZX90PTP	weiß :: Weiße Farbe sollte verwendet werden, um eine niedrigere Temperatur und eine kühlere Umgebung im Inneren des Zwingers aufrechtzuerhalten, da die weiße Farbe dem Experiment zufolge den Innenraum weniger warm macht, als wenn dunkle Farben verwendet würden.
es_3NQL1CS15TLYNGY7ILFP3LSW208VY0	schwarz :: Das schwarze Oberteil führt bei allen Versuchen zu einer wärmeren Temperatur. Die schwarze Farbe absorbiert mehr Wärme.
es_3NVC2EB65SCEB7WOYB9JKQ0D3XC3YY	weiß :: Die beste Farbe ist weiß, da sie weniger Wärme speichert. Auf diese Weise wird der Hund der beiden Kinder nicht an der Hitze sterben.
es_3O7L7BFSHG2VV5XGJD4CHTAM70SEIF	hellgrau :: grise claro
es_3OE22WJIGK1P1ZILMLOQUDNBM53UQV	hellgrau :: Die Ausgangstemperatur betrug bei allen Versuchen 24 °C.
es_3OF2M9AATI1KCVE0F331FJQHMHBZKF	weiß :: Das Haus würde mit Weiß kühler wirken.
es_3OF2M9AATI1KCVE0F331FJQHR6QKZY	weiß :: Die weiße Farbe absorbiert am wenigsten Energie, so dass die Lufttemperatur im Haus am niedrigsten ist. Die Testergebnisse bestätigen die Hypothese.
es_3OHYZ19UGEI21ER713FV57GHWVJOAF	weiß :: Ein weißer Anstrich des Schuppens hält ihn kühler, da helle Farben weniger Wärme speichern.
es_3OLF68YTNBE8V1EE20W5ID73AQ8FAY	schwarz :: weil diese Farbe mehr Punkte hatte.
es_3OLQQLKKNU2RQGHM1VPCTUPMNS3EJ6	hellgrau :: Weiß reflektiert die Strahlungsenergie, während dunkle Farben wie Grau oder Schwarz sie absorbieren. Je wärmer das Dach ist, desto wärmer wird es auch im Haus sein. Deshalb habe ich mich für ein helles Grau entschieden, damit das Innere des Hauses weder zu kalt noch zu warm ist.
es_3OS4RQUCRBSDEBJ68EW1DOR9Q3VBFF	weiß :: Viel weniger Hitze
es_3OSWBBLG1GANTU8BM4TTELFGTX0XD0	weiß :: Anhand der Ergebnisse des Experiments habe ich festgestellt, dass weiß die beste Option wäre. Im Vergleich zu den anderen Farben hat Weiß die geringste Wärmeaufnahme.
es_3OVR4I9USRWQK1O67FX8H9PHMC44QA	weiß :: Ich wähle weiß, weil die Daten aus den drei Tests zeigen, dass das Haus eine kühlere Temperatur haben würde, als meine Familie bevorzugt. Wir leben in Texas, wo die meisten Tage warm sind.
es_3OWEPKL08BP20RTXTL3YGREM4BB7NQ	weiß :: Weiß wäre die ideale Farbe, denn je heller es ist, desto kühler wird es in der Hundehütte sein, da helle Farben weniger Energie absorbieren, d.h. die Atmosphäre wird nicht so heiß sein.
es_3OWEPKL08BP20RTXTL3YGREM4LIN7X	weiß :: Anhand der Tabelle stelle ich fest, dass weiß eine niedrigere Raumtemperatur ergibt, so dass Brandi und Jerrys Hund sich wohler und kühler fühlen werden, die andere Option könnte hellgrau sein, da der Temperaturunterschied nicht sehr groß ist, schwarz ist definitiv keine Option, da der Temperaturanstieg zu hoch ist.
es_3OXV7EAXLG3CSNMISSER1ZGK4IQ36V	weiß :: Wenn sie den Zwinger für ihren Hund streichen, achten sie auf die Auswirkungen der Farbe auf die Temperatur im Inneren.  Ein Hund wird in einer zu heißen Umgebung sehr leiden (und möglicherweise sterben), und Sie brauchen eine Hundehütte, die nicht so viel Wärme absorbiert.  Aus dem Experiment geht hervor, dass die dunkleren Deckel mehr Wärme zurückhalten (bei allen Tests), während der weiße Deckel weniger Wärme zurückhält.  Wir sehen also, dass Weiß die beste Farbe ist, wenn wir eine Farbe suchen, die nach einer langen Zeit in der Sonne kühler ist.  Und eine weniger warme Temperatur ist besser für den Hund.
es_3P59JYT76NXT931BK58FTZ36NL62TM	weiß :: weiß wäre gut, denn wenn die Raumtemperatur 24 Grad beträgt, bedeutet das, dass es bereits eine angenehme Temperatur ist und nicht mehr geheizt werden muss, also würde weiß eine gute Temperatur für den Hund beibehalten.
es_3PDJHANYK7TRMVTH7D3T5THUNM96H4	weiß :: Die schwarze Farbe absorbiert viel Wärme und lässt Licht und Wärme nicht entweichen, weshalb die Temperatur im Inneren des Zwingers bei schwarzer Farbe ansteigen würde. Deshalb habe ich mich für Weiß entschieden, um dem Zwinger mehr Frische zu verleihen.
es_3PDJHANYK7TRMVTH7D3T5THUSW1H6W	weiß :: Die weiße Farbe reflektiert das Licht und die Temperatur ist daher niedriger.
es_3PEIJLRY6V6M20823ZYJ6941298WX4	schwarz :: ICH GLAUBE, DASS SCHWARZ DIE TEMPERATUR LÄNGER HALTEN WIRD
es_3PEIJLRY6V6M20823ZYJ69412R5WX1	weiß :: Dem Experiment zufolge ist Weiß die Farbe, die die Temperatur des Ortes, in diesem Fall des Zwingers, am wenigsten erhöht. Der Hund wird sich in einer kühleren Umgebung wohler fühlen, obwohl die Hundehütte zusätzlich belüftet werden müsste.
es_3PEIJLRY6V6M20823ZYJ6941ZPWXWM	weiß :: Das Experiment hat gezeigt, dass die Farbe Weiß die Luft im Inneren des Zwingers weniger warm macht, daher könnte man annehmen, dass ein weißes Dach dazu beitragen kann, dass der Zwinger für den Hund kühler wird.
es_3PIWWX1FJLJZ1W3EFW03QA2ERNMJJS	weiß :: So bleibt sie so frisch wie möglich.
es_3PJ71Z61R6F303A13V3KXGSPW0Q19K	weiß :: Die Lampe kann nur eine bestimmte Temperatur erreichen.
es_3PJ71Z61R6F303A13V3KXGSPZAJ190	weiß :: Mit dieser Farbe würde der Zwinger weniger Energie absorbieren, basierend auf den Ergebnissen der Übung, so dass die Lufttemperatur im Inneren des Zwingers so niedrig wie möglich ist, was es für den Hund angenehmer macht.
es_3PWWM24LHUBABJ9NH7XK237J58X82B	weiß :: für einen besseren Wärmekomfort Ihres Hundes sollten Sie den weißen Bezug verwenden.
es_3PZDLQMM0VYCNMZ0YJDP4P32U3R2CR	weiß :: Es ist die Farbe, die das Haus kühler hält.
es_3Q5C1WP23OEKZG8P05Q3L0NNA4J155	weiß :: Die weiße Farbe absorbiert die geringste Energiemenge, daher ist die Temperatur im Haus niedriger als bei einer dunkleren Farbe. Die gleiche Argumentation wird durch das Experiment mit den verschiedenfarbigen Deckeln unterstützt.
es_3QEMNNSB2ZCTEF2K4RPVKM2SR19D73	hellgrau :: Je dunkler die Farbe des Äußeren, desto mehr Energie wird absorbiert, wobei Weiß die Farbe ist, die am wenigsten Energie absorbiert, und Schwarz die meiste. Daher würde im Sommer eine schwarze Farbe die Innentemperatur stark ansteigen lassen, während eine weiße Farbe die Innentemperatur angenehmer machen würde. Im Winter wäre es umgekehrt, eine dunkle Farbe wäre interessanter, also wäre vielleicht eine Zwischenfarbe ideal.
es_3QIYRE09Y5UOP5EV45MPFHN91OS1N2	weiß :: Den Angaben zufolge absorbieren dunkle Farben mehr Energie. Daher wäre eine hellere Farbe die richtige Farbe, da sie die niedrigste Temperatur hat.
es_3QJOXOW4XL4HRON74S249MH3M8HEMW	weiß :: Wenn das Klima, in dem der Hund leben wird, warm ist, ist die beste Farbe weiß, um den Innenraum kühler zu halten.
es_3QJOXOW4XL4HRON74S249MH3M9UEMB	weiß :: Weiß ist die Farbe mit der niedrigsten durchschnittlichen Lufttemperatur im Inneren des Glasbehälters. Weiß ist die Farbe, die am wenigsten Energie absorbiert, so dass sie das Innere des Hauses am wenigsten beeinträchtigen würde.
es_3QUO65DNQW1MGN5578WM58SB3YYUOK	weiß :: Indem sie die Hütte weiß streichen, sorgen Brandi und Jerry dafür, dass die Hitze in der Hütte geringer ist, als wenn sie sie in einer anderen Farbe streichen würden. Der Grund dafür ist, dass sich ihre Hypothese nach Experimenten mit anderen Farben als richtig erwiesen hat.
es_3QXNC7EIPK83TEPJ7CZKJB9FRLR90M	weiß :: Die Farbe weiß wird gewählt, damit sich der Zwinger nicht so stark aufheizt und der Hund sich wohler fühlt, wie aus den Daten in der Versuchstabelle hervorgeht. Durch die Wahl einer helleren Farbe heizt sich das Innere des Zwingers weniger auf. Es ist auch bekannt, dass schwarze oder undurchsichtige Farben (wie Hell- oder Dunkelgrau) dazu neigen, mehr Strahlung zu absorbieren.
es_3QY7M81QH9Z1SL8UW8BIOZXID5P7KL	hellgrau :: tagsüber kann der Hund gut aufstehen und das Licht sehen. Dann hat das Hündchen nachts Ruhe zum Schlafen.
es_3QY7M81QH9Z1SL8UW8BIOZXIDGNK7I	weiß :: Wenn die Temperatur des Zwingers der des Experiments entspricht, wähle ich weiß, denn 53, 48 und 45 Grad sind für jedes Tier zu viel.
es_3R08VXYT7E8SNL2BLMULCARDYL0W7O	weiß :: Ein weißer Anstrich des Hauses würde verhindern, dass es an einem sonnigen Tag heiß wird, da Weiß die Sonnenenergie stärker reflektiert als eine dunklere Farbe. Der Test mit den verschiedenfarbigen Deckeln hat gezeigt, dass von den vier Farben Weiß die Temperatur im Inneren des Glases am wenigsten ansteigen lässt.
es_3R0T90IZ1UP22G77XYYE6TX3CZDGC3	weiß :: Weiß, weil das Haus im Sommer kühler und im Winter wärmer ist.
es_3R3YRB5GRHGXEJB4XPR44D86DF1UAN	weiß :: Weiß wäre eine bessere Farbe für die Farbe der Hundehütte, da sie weniger Sonnenenergie absorbiert und der Hund somit eine nicht zu heiße Hütte hat. Das Experiment zeigt deutlich, dass dunkle Farben mehr Energie und mehr Wärme absorbieren.
es_3R3YRB5GRHGXEJB4XPR44D86H7GUAQ	weiß :: Die Farbe Weiß verhindert die Überhitzung des Schuppens bei direkter Sonneneinstrahlung, insbesondere im Sommer.
es_3R6BYFZZP9PKREM7DAOJ2LI16Z8XFI	weiß :: Das hängt von der gewünschten Temperatur ab. Wenn Sie an einem warmen Ort leben, ist es am besten, weiß zu verwenden, um die Hundehütte kühler zu halten. Wenn Sie an einem kalten Ort leben, wäre schwarz ideal, um den Zwinger wärmer zu halten.
es_3R6BYFZZP9PKREM7DAOJ2LI1BUQXFV	weiß :: Weiß wäre die idealste Farbe, denn so wird es nicht zu heiß, wenn die Sonne auf den Zwinger trifft, wenn die Hunde drinnen sind.
es_3RANCT1ZVHU2XTGW33R0ZOSCVWEUB8	weiß :: Unabhängig von ihrer Farbe nehmen die meisten festen Oberflächen, die einer Strahlungswärmequelle ausgesetzt sind, Wärme auf und geben sie an ihre Umgebung ab, wodurch sich ihre Temperatur erhöht. Je nach Farbe absorbieren diese Oberflächen jedoch unterschiedlich viel Wärme. Das Experiment zeigte, dass Oberflächen mit dunkleren Farben in 10 Minuten mehr Wärme absorbieren als Oberflächen mit helleren Farben. Wenn Brandi und Jerry also eine hellere Farbe für die Farbe ihrer Hundehütte wählen, wird mehr Sonnenstrahlung vom Dach und den Wänden reflektiert, die sich weniger aufheizen und weniger Wärme in die Hundehütte leiten. Das ist wichtig, denn das Sonnenlicht fällt nicht nur für 10 Minuten auf das Haus, sondern für viele Stunden am Tag, manchmal bis zu 15 Stunden. Es gibt jedoch einen Unterschied: Das Experiment wurde mit einem luftdichten Wärmebehälter durchgeführt (oben mit einem Deckel und an den Seiten und unten mit Glas verschlossen). Andererseits hat die Hundehütte eine Öffnung, durch die der Hund ein- und ausgeht, so dass die Luft ein- und ausströmen kann und das Innere der Hütte kühler wird.  In der Wand gegenüber dem Eingang der Hundehütte kann ein kleines Fenster eingebaut werden, so dass die Luft effektiv durch das Haus strömen und es weiter kühlen kann.
es_3RJSC4XJ127KSRN74MM37V4DA7F05Y	weiß :: Die weiße Farbe des Zwingers bedeutet, dass das Innere des Zwingers nicht so heiß ist, so dass der Hund im Sommer nicht zu heiß wird.
es_3RKNTXVS3OBYXLHPIJ0MR9ACGP44AD	weiß :: Brandi und Jerry sollten die hellere weiße Farbe für den Standplatz ihres Hundes wählen, weil der Hund dann nicht zu heiß wird.  Die Temperaturen für Weiß waren niedriger als für Hellgrau, Dunkelgrau oder Schwarz.  Es wäre also wahrscheinlich eine gute Dachfarbe.
es_3RRCEFRB7OP3GVMHOX0IMKUI0IA4BH	weiß :: Ich habe mich für weiß entschieden, denn je dunkler die Farbe des Deckels ist, desto mehr steigt die Lufttemperatur an, was für Ihren Hund unangenehm wäre. Zweifellos ist Weiß die beste Wahl für den Hund, da die Temperatur weniger ansteigt.
es_3RRCEFRB7OP3GVMHOX0IMKUIWKVB49	weiß :: Wenn eine dunkle Farbe für den Zwinger verwendet wird, könnte sich die Luft im Inneren des Zwingers zu sehr aufheizen und den Hund ersticken; daher wurde die Farbe weiß gewählt, damit sich der Zwinger beim Auftreffen des Sonnenlichts so wenig wie möglich aufheizt, ohne eine gefährliche Temperatur zu erreichen. Laut Tabelle kann sich weiß bis zu 43º aufheizen, während schwarz zum Beispiel 54º erreicht....
es_3RSDURM96CZHL5CLNVQF3H4AVIPYE0	Dunkelgrau :: Ich denke, diese Farbe ist perfekt, da Schwarz zu warm ist und Weiß nicht die richtige Farbe für ein Tier ist, da es sehr schnell schmutzig wird.
es_3RU7GD8VPQ6OMAP2X3E1F7FDR2ZSP0	weiß :: Die Farbe sollte weiß sein, da sie weniger Strahlung absorbiert und somit verhindert, dass die Temperatur ansteigt und das Tier während des Tages an der Sonneneinstrahlung erstickt.
es_3RU7GD8VPQ6OMAP2X3E1F7FDRD6PSQ	weiß :: Gegen die Kälte kann ich Decken verwenden, aber das schlimmste Problem wäre die Hitze im Sommer, wenn ich sie also weiß mache, wird es weniger warm.
es_3RU7GD8VPQ6OMAP2X3E1F7FDSP4SPG	weiß :: Wir werden für die Hundehütte weiß wählen, damit sie im Sonnenlicht kühler bleibt. Tests haben gezeigt, dass die weiße Abdeckung weniger Wärme absorbiert als jede andere Farbe.
es_3RU7GD8VPQ6OMAP2X3E1F7FDWLJPSO	weiß :: Ein weiß gestrichenes Haus heizt sich weniger schnell auf als jede andere Farbe.
es_3RWE2M8QWJNOIGTD8MIP1C4ZXYI0NZ	Schwarz :: Die Farbe Schwarz wirkt sich auf die Temperatur im Inneren des Gebäudes aus, da Schwarz mehr Sonnenwärme absorbieren kann als andere Farben.
es_3RWE2M8QWJNOIGTD8MIP1C4ZZXKN0O	weiß :: Weiß ist besser, weil die anderen Farben offenbar mehr Energie absorbieren. Das Innere der Hundehütte würde mit den andersfarbigen Farben wärmer werden, genauso wie das Glasgefäß mit den andersfarbigen Deckeln wärmer werden würde.
es_3RXCAC0YIT20QDHUGMI9471KEH68GD	weiß :: kühler und kälter
es_3RXCAC0YIT20QDHUGMI9471KFGX8G3	Weiß :: Die Wahl der Farbe Weiß für die Hundehütte garantiert ein angenehmeres Umfeld für das Tier, da die Temperaturen von 41 und 43 Grad Celsius im Vergleich zu den anderen Farben am niedrigsten sind, weshalb Weiß die richtige Farbe für die Hundehütte ist.
es_3RXCAC0YIT20QDHUGMI9471KGF6G8J	negro :: temperatura del aire auf der Tabelle Kategorien
es_3RXPCZQMQROIFDX9H19UPXEC4FM1GK	hellgrau :: nicht zu heiß und nicht zu dunkel
es_3RXPCZQMQROIFDX9H19UPXEC4YJG1Y	weiß :: Um den Ständer nicht zu sehr zu beschädigen.
es_3SITXWYCNXMUEXAR882NJVRGSDZBXM	dunkelgrau :: Die Temperatur in allen Studien für die Farbe dunkelgrau bleibt unverändert.
es_3SKEMFQBZ5I5SZDD6D3O2ZTDNL0K8H	gris claro :: Giris Claro
es_3SKRO2GZ734NHZTS7SU9NP659SVK1O	weiß :: Weiß scheint die Farbe zu sein, die am wenigsten Energie absorbiert und die Lufttemperatur stabiler hält. Die idealste Farbe für die Hundehütte ist weiß, auch wenn eine Art von Isoliermaterial erforderlich ist, um die Innentemperatur zu senken.
es_3SLE99ER0PQJJSA69QQ8GG7R1DWBZJ	weiß :: Die weiße Farbe würde sich auf das Innere des Zwingers auswirken und ihn kälter machen als jede andere Farbe. Die Ergebnisse des Experiments zeigen, dass die Temperatur im Zwinger umso niedriger ist, je heller die Farbe ist. Da Hunde gerne bei kühleren Temperaturen leben, wäre Weiß die am besten geeignete Farbe.
es_3SNLUL3WO60EA228UGGUDROHAFCLUN	weiß :: Wie aus dem Experiment und den obigen Ergebnissen hervorgeht, ist die Temperatur umso höher, je dunkler die Farbe des Deckels ist. Diese Schlussfolgerung lässt sich ziehen, wenn man die Frequenzen des Lichts und den Anteil des reflektierten Lichts berücksichtigt. Je dunkler die Farbe ist, desto mehr Licht wird absorbiert und desto höher ist die Temperatur. Wenn wir also eine höhere Temperatur im Haus erreichen wollen, müssen wir die dunkelste Farbe wählen, in diesem Fall Schwarz. Um jedoch zu verhindern, dass sich das Innere des Zwingers zu sehr aufheizt, wäre es ratsam, eine hellere Farbe zu wählen, die in diesem Fall weiß wäre.
es_3T3IWE1XG80A1M3WMGYGPH190L5QTU	weiß :: Weiß zieht weniger Sonnenenergie an und erreicht eine niedrigere Temperatur als Schwarz, das mehr Energie anzieht.
es_3TEM0PF1Q7AFW420JS4M57S5IZ60DG	weiß :: Auf den ersten Blick würde ich weiß sagen, aber das hängt auch von der Außentemperatur ab. Bei extremer Hitze wäre die ideale Farbe weiß, und bei extremer Kälte wäre die ideale Farbe schwarz. Grüße!
es_3TEM0PF1Q7AFW420JS4M57S5KLQD0N	weiß :: Es wurde angenommen, dass dunkle Farben das Licht absorbieren und die Temperatur erhöhen würden. Da die gemessene Lufttemperatur im Inneren des Containers mit dunkleren Farben anstieg, ist dies eindeutig. Die Wärmeübertragung erfolgt durch Konduktion von der Decke und Konvektion der Luft im Inneren.
es_3TGOYF991ZZHTSP23U8V4EK0L3SUU5	weiß :: In allen drei Tests war die durchschnittliche Temperatur der Farbe weiß 10 Grad niedriger als die durchschnittliche Temperatur der Farbe schwarz.
es_3TMFV4NEPARWNZ7UVRMRQAN8BBG8WB	weiß :: Die weiße Farbe würde die Temperatur im Haus niedrig halten. Die Flasche mit dem schwarzen Deckel hat die niedrigsten Temperaturen.
es_3TOK3KHVJVVKICT9U03BVGERW9F7OI	weiß :: Weiß trägt dazu bei, einen Teil der Temperatur aus dem Innenraum zu reflektieren, hält ihn aber in der Nacht auf einer angenehmen Temperatur.
es_3TOK3KHVJVVKICT9U03BVGERXTOO7D	weiß :: Je dunkler die Farbe des Zwingers ist, desto mehr zieht er die Sonnenstrahlen an und absorbiert sie, wodurch der Zwinger im Sommer ungesunde Temperaturen für Ihr Haustier erreicht. Aus diesem Grund wäre ein weißer Anstrich des Zwingers am besten geeignet, da die Sonnenstrahlen nicht vom Zwinger absorbiert werden, da dieser im Freien steht.
es_3TOK3KHVJVVKICT9U03BVGERXXDO7A	weiß :: Bei Verwendung von weißer Farbe ist die Temperatur im Inneren der Hundehütte niedriger als bei Verwendung anderer dunklerer Farben wie Grau oder Schwarz.
es_3TS1AR6UQSRQCZGGVXKL8M5D2IRF7P	weiß :: Je dunkler die Farbe ist, desto wärmer misst das Thermometer. Im Falle des Schuppens müsste man, um eine niedrigere Temperatur zu erreichen, die hellste Farbe verwenden, die möglich ist.
es_3TS1AR6UQSRQCZGGVXKL8M5D2LAF7E	weiß :: die weiße Farbe würde den Zwinger für Ihren Hund viel kühler machen, da die Abbildung zeigt, dass es sich um einen niedrigeren Temperaturanteil handelt.
es_3TU5ZICBRFER32B8JINLYL5MK498Q2	schwarz :: Die schwarze Farbe würde dazu beitragen, die Temperatur im Zwinger höher zu halten als bei den anderen Farben.
es_3TVRFO09GMS6R6W3ZLRHXYNL680LXA	schwarz :: Die schwarze Farbe würde die Temperatur im Haus erhöhen (die durchschnittliche Temperatur nach den 4 Tests ist höher). Da es sich um einen Außenzwinger handelt (und wir von einem kalten Klima ausgehen), wäre Schwarz die richtige Farbe.
es_3TVSS0C0E3DFLJZIYPXMH6JVR5JWT6	weiß :: Nach den Ergebnissen des Experiments erzeugte die weiße Farbe weniger Wärme im Inneren des Behälters, daher wurde die Entscheidung für die weiße Farbe getroffen.
es_3U088ZLJVM6E5A2R0N9CXVHQU3X0WR	schwarz :: NEGRO FARBE
es_3U0SRXB7CFICIADC2Z14L85M5MPNRN	weiß :: Weiße Farbe reflektiert viel mehr Strahlung von der Lampe, daher wird das Innere des Gebäudes auf einer niedrigeren Temperatur gehalten, als wenn schwarze Farbe verwendet wird.
es_3U4J9857OGO0ZI40QVYPPWESQRY7BF	schwarz :: Die Temperatur des Hauses mit der Farbe schwarz wird höher sein, denn nach drei Tests ist dies die einzige Farbe, die durchgängig von einer Temperatur von über 50 Grad Celsius abgewichen ist.
es_3U4J9857OGO0ZI40QVYPPWESSJ0B77	weiß :: Es ist wichtig, dass das Innere des Zwingers kühl ist. Sie können eine Decke hinzufügen, falls es zu kalt ist, aber es ist schwierig, die Temperatur zu senken. Da das Experiment gezeigt hat, dass die weiße Farbe den Innenraum kühler erscheinen lässt, sollten Sie die Hundehütte weiß streichen.
es_3U5JL4WY5MMATYPITTS0BHLAFMDX4W	weiß :: Ich denke, wenn die Hundehütte den Hund vor Hitze und Sonne schützen soll, sollte die Abdeckung weiß sein, da sie weniger Energie absorbiert und das Innere somit kühler ist. Soll die Hundehütte hingegen den Hund vor Kälte schützen, sollte der Deckel schwarz sein, da er dann mehr Wärme und Licht absorbiert und das Innere wärmer ist.
es_3U5NZHP4LTFZW1BMM922BT8BNCMPHR	weiß :: Wie aus den Tests hervorgeht, ist weiß die Farbe, die die Innentemperatur des Zwingers am wenigsten erhöht. Wendet man diese Regel also auf die Farbe des Zwingers an, so ist die ideale Farbe weiß, die erwiesenermaßen die Innentemperatur am wenigsten erhöht.
es_3U84XHCDIEQZYTPXUBGL821LSUR4Z1	weiß :: Je dunkler die Farbe des Deckels ist, desto höher ist die Temperatur im Inneren des Zwingers.  Für das Tier ist es weniger wichtig, dass die Temperatur stabil ist und nicht abrupt ansteigt, je heller die Farbe, desto besser.
es_3U84XHCDIEQZYTPXUBGL821LSXAZ4L	weiß :: Soll die Wärme von außen in das Innere des Gebäudes abgeleitet werden, so ist die Farbe Weiß aufgrund ihrer geringen Wärmeenergieaufnahmefähigkeit die geeignete Farbe, wie aus dem Diagramm hervorgeht, das als Ergebnis des vorherigen Versuchs erstellt wurde.
es_3UN61F00HY28SL76YZ5IRR50HEVR50	Weiß :: Die Testergebnisse zeigen, dass Weiß am wenigsten Licht absorbiert und sich daher am wenigsten erwärmt. Deshalb hat es auch die niedrigste Durchschnittstemperatur.
es_3UOUJI6MTFR9AWJX8ZJIOLJ4H0KXU7	hellgrau :: schwarz
es_3UXUOQ9OKGAVG8Z8KHYTULUMDW0A7P	Dunkelgrau :: Dunkelgrau wäre eine ausgezeichnete Farbe für die Außenseite der Hundehütte, würde aber die Innentemperatur beeinträchtigen, wenn sie der Sonne ausgesetzt ist, da Dunkelgrau nach den Ergebnissen des Experiments dazu neigt, die Innenlufttemperatur zu erhöhen.
es_3V5Q80FXIZ4OAM3H5Q2OBMZ8OC623T	Dunkelgrau :: Diese Farbe ist besser als Schwarz, weil sie die Temperatur für das Haustier angenehm hält. Schwarz wäre zu warm, weil der Körper des Tieres wärmer ist. Das dunkle Grau wird nicht zu warm sein, aber es wird die Temperatur besser regulieren.
es_3VA45EW49P067QE75KM2U6NESX01OJ	hellgrau :: Experimente haben gezeigt, dass Weiß viel Licht reflektiert und die Wärmeaufnahme verringert. In einer Umgebung, in der der Hund im Schatten kühl bleiben möchte, ist Weiß die ideale Farbe, da es im Inneren des Zwingers kühler ist als bei einem schwarzen Anstrich.
es_3VAR3R6G1REOIQYS45VH9GAM6N18O9	weiß :: Mit dieser Farbe wird das Haus kühler.
es_3VAR3R6G1REOIQYS45VH9GAM8D3O89	schwarz :: Die schwarze Farbe hatte die besten Ergebnisse von allen anderen.
es_3VBEN272MMCI9XW3UKOELY1LQB5SGP	Dunkelgrau :: Es verleiht dem Gebäude mehr Wärme, da die Sonnenenergie durch die dunklere Farbe stärker in das Innere gelangt. Es war auch die Farbe mit der gleichen Punktzahl, so dass die Vielfalt die gleiche sein würde.
es_3VHP9MDGRPXWOGBCMESWO8XRA75FC4	schwarz :: die Farbe kann weiß sein
es_3VP0C6EFSI9DE9USYAJ6XYPQCS0M6X	Schwarz :: Schwarz kann sich auf das Innere des Hauses auswirken, indem es die Temperatur des Raumes erhöht; es hatte die höchste Durchschnittstemperatur nach 10 Minuten im Inneren des Glasgefäßes.
es_3VP0C6EFSI9DE9USYAJ6XYPQCX76MY	weiß :: Nach dieser Tabelle ist die perfekte Farbe weiß. Da die Tests 1 und 2 und 3 die perfekte Kombination in dieser Farbe sind, passen auch die Mittel perfekt zusammen. So Farbe Jerry ist perfekt zu wählen ist weiß.
es_3W8CV64QJ4CE4EVF5K65P38WE8G9HO	weiß :: Verhindert einen übermäßigen Temperaturanstieg im Zwinger und sorgt für eine wärmere Umgebung für den Hund.
es_3WAKVUDHUYTFVHD6QMFKUM6GC9ZU74	hellgrau :: Die Hundehütte soll nicht überhitzen, also sollte ich eine helle Farbe wählen. Bei hellem Grau wird die Temperatur kühl, aber nicht zu kalt sein. Zwischen der höchsten Temperatur (schwarz) und der niedrigsten Temperatur (weiß) besteht ein Unterschied von etwa 12 Grad. Dies ist eine sehr drastische Veränderung, und ein weißes Haus kann im Winter zu kalt sein. Deshalb habe ich mich für Hellgrau entschieden.
es_3WAKVUDHUYTFVHD6QMFKUM6GCOSU7R	hellgrau :: HELLGRAU, WEIL ES DIE TEMPERATUR KONTROLLIERT HÄLT
es_3WI0P0II6353WYMZD5N1P3TSTGQRDA	schwarz :: Schwarze Farbe würde Licht absorbieren
es_3WMOAN2SRDA4BHUTBJ6EM5UPQ0FVNH	weiß :: Die schwarze Farbe absorbiert das Licht und die Wärme, die von der Lampe ausgestrahlt wird, deshalb ist es besser, die weiße Farbe zu verwenden, um den Schuppen kühler zu halten.
es_3WOKGM4L73T601TP91I2G144QZFO0F	weiß :: Weiß reflektiert im Allgemeinen Licht, anstatt es zu absorbieren. Das Experiment zeigt zwar, dass sich die Luft draußen immer noch erwärmt, aber sie steigt nie auf das Niveau von Schwarz. Ich denke, wenn die Temperatur draußen niedriger bleibt, wird es auch im Inneren der Box kühler bleiben.
es_3WQQ9FUS6C74ZW9J00QV3WAN05R8BD	weiß :: hoher Kontrast
es_3WR9XG3T65OGEJJRBGO2HI8MJNH47L	schwarz :: Die Verwendung eines schwarzen Deckels könnte die Temperatur im Inneren des Hauses erhöhen. Anhand der Ergebnisse des Experiments können wir feststellen, dass der Innenraum mit dem schwarzen Deckel durchgehend die höchste Temperatur aufweist.
es_3WRFBPLXRC1KZ8SAR9083A260GV3N2	weiß :: Wenn die Farbe weiß ist, entsteht weniger Wärme im Inneren des Zwingers, denn die Ergebnisse zeigen, dass der Deckel weniger Wärme absorbiert, wenn die Farbe heller ist. Ich nehme an, dass Brandi und Jerry nicht wollen, dass ihr Hund an Hyperthermie stirbt.
es_3WYGZ5XF3YSNBJSMKB9TJQTE0PVSKY	Weiß :: Wenn Sie die Farbe Weiß für die Hausfarbe wählen, ist es weniger warm und angenehmer für den Hund. Oder wenn Sie eine dunklere Farbe wie Schwarz wählen, steigt die Temperatur im Haus, was nicht gut ist.
es_3WYGZ5XF3YSNBJSMKB9TJQTEXSNSKT	schwarz :: Die schwarze Farbe absorbiert mit Sicherheit mehr Energie und heizt den Innenraum daher stärker auf.
es_3X08E93BHXVBP690BUCP82S4F6B66I	weiß :: Je dunkler der Deckel des Behälters ist, desto mehr Wärme kondensiert im Inneren, daher sollte die Hundehütte so hell wie möglich sein, damit die Sonnenstrahlen die Temperatur nicht ansteigen lassen.
es_3X1FV8S5JZ4Y1PD7OFTJWLLSSLZGVX	weiß :: Je dunkler die Farbe ist, desto stärker wird die Temperatur beeinflusst.  Die weiße Farbe zeigt, dass sie am wenigsten betroffen war.
es_3X3OR7WPZ1DGC5VVRDFPHZ6SF8RL8K	weiß :: Die Hundehütte sollte bequem sein. Weiß absorbiert weniger Wärme, daher ist Weiß die beste Wahl. Je dunkler sie ist, desto mehr Wärme absorbiert sie, so die Ergebnisse.
es_3X4JMASXCOMMH74G5WDGAH45JU9B0Z	hellgrau :: HELLGRAU IST DIE BESTE WAHL, WEIL DER HUND BEI KÄLTE vor der Kälte geschützt ist und BEI WÄRMEREN Temperaturen eine bessere Temperatur in seiner Küche hat.
es_3X4MXAO0BI1254MQU0SRHRIDZ6ARWG	schwarz :: Das Dach der Hütte ist schwarz gestrichen, und angesichts der Ergebnisse des Experiments kann davon ausgegangen werden, dass die Temperatur im Inneren der Hütte höher ist als bei den anderen Farben, wenn die Hütte im direkten Sonnenlicht steht. Diese Annahme berücksichtigt nicht die Auswirkungen möglicher Luftströme in der Hütte, da die Hütte nicht vollständig geschlossen ist, wie das Boot in dem oben beschriebenen Experiment.
es_3X73LLYYQ3RZTGZ96UPA743GL3PHN1	weiß :: Diese Antwort ist einfach, ich werde mich kurz fassen. In meiner Universität habe ich im Kurs für Innenbeleuchtung gelernt, dass die oben genannten Lichtfarben die besten für den Innenbereich sind, weil sie es erlauben, die Temperatur und das von der Lampe ausgestrahlte Licht zu verteilen.
es_3X73LLYYQ3RZTGZ96UPA743GNXGHNI	Je nach Größe und Rasse unseres Hundes unterscheiden wir 3 Arten von Hundehütten: Hundehütten für große Hunde, Hundehütten für mittelgroße Hunde oder Hundehütten für kleine Hunde. Die perfekte Hundehütte für Ihren Hund ist diejenige, die es ihm ermöglicht, ohne Probleme hineinzugehen, aufzustehen, darin herumzulaufen und sich hinzulegen. Wenn wir dagegen eine zu große Hundehütte kaufen, ist sie schwieriger zu beheizen und unser Hund könnte frieren, vor allem im Winter, wenn die Temperaturen extremer sind.
es_3X87C8JFV8O9MMQHXGTQFC5NX7HQS4	weiß :: Unter der Annahme, dass die Sonne direkt über dem Zwinger steht, ist nach den Ergebnissen des Experiments die ideale Farbe weiß, da sie an heißen Tagen die niedrigste Temperatur für den Hund ermöglicht.
es_3XC1O3LBOUZZAPNJUBQK8V2FOBWLT4	weiß :: Weiß ist die beste Farbe, weil sie eine angenehmere Temperatur für den Hund bietet.
es_3XIQGXAUMEL7CL71VRQ7ET5K667X7K	Dunkelgrau :: Diese Farbe könnte sich auf das Innere des Schuppens auswirken. Verwenden Sie die Ergebnisse des Experiments
es_3XXU1SWE8O8HYXZOZIDKF6KZYNI0A6	schwarz :: Wenn der Hund in einer kalten Region lebt, kann die Farbe Schwarz in seinem Zwinger dazu beitragen, dass er eine wärmere Temperatur behält.
es_3Y5140Z9DZTZSWM6SRKNB59QL8PIP1	weiß :: Da es weiß ist, absorbiert es am wenigsten Energie, so dass das Haus während des heißen Sommers kühl bleibt, wie in 1 und 3 gezeigt, zusammen mit dem Durchschnitt von 41 Grad Celsius. Wenn die ideale Farbe für den Winter schwarz ist, absorbiert sie so viel Energie wie möglich und hält das Haus warm.
es_3Y54SXRO1NY2TFAD3PILZIYY3OJUTB	weiß :: Die weiße Farbe absorbiert weniger Energie, so dass das Innere des Zwingers eine niedrigere und angenehmere Temperatur für das Tier aufweist.
es_3Y9N9SS8L0OBDW1X2FM575QCTZO3DW	weiß :: So bleibt die Hütte ein bisschen kühler.
es_3YDGXNSEO17KEXOALLG8VI4HOCP84I	weiß :: Farbe hat eine große Wirkung auf das Haus. Je dunkler die Farbe, desto wärmer wird das Haus sein. Weiß ist also die beste Farbe für die Hundehütte.
es_3YDTZAI2WZT23X4PM07TG8H9A9614K	weiß :: Weiße Farbe absorbiert weniger Energie als graue oder schwarze Farbe. Wie aus dem Experiment hervorgeht, war die Temperatur im Inneren des Glasgefäßes mit dem weißen Deckel am niedrigsten im Vergleich zu den schwarzen und grauen Deckeln. Daher ist die weiße Farbe die beste Wahl für die Hundehütte, da sie das Innere der Hundehütte bei einer niedrigeren Temperatur als die schwarze und graue Farbe halten würde.
es_3YDTZAI2WZT23X4PM07TG8H9CYT41Q	schwarz :: Das Haus würde im Wert sinken.
es_3YGXWBAF72UMQ0EN2XWDX400MYO4CW	dunkelgrau :: Dunkelgrau lässt die Temperatur auf dem Niveau.
es_3YJ6NA41JDTVN76CA95NN6OQZDZJPG	weiß :: Weiß ist die ideale Farbe, weil sie weder zu kalte noch zu warme Temperaturen bringt.
es_3YMTUJH0DUT3CHGYOJR3ME042S5T4T	schwarz :: je dunkler, desto besser
es_3YOH7BII0BK33B9QE6EYUDDL1JBKVZ	weiß :: Die weiße Farbe ergab die niedrigste Temperatur im Zwinger. Eine Hundehütte steht den ganzen Tag in der Sonne und muss kühl gehalten werden, damit sich der Hund wohl fühlt. Aus diesem Grund ist ein weißer Anstrich des Zwingers die beste Lösung.
es_3YT88D1N0ABJR277UW8SBIL26RC3KV	Dunkelgrau :: Die Farbe und die Dunkelheit werden den Innenraum nicht zu sehr beeinflussen. Denn die dunkelgraue Farbe lässt genügend Licht herein, um eine neutrale Temperatur zu erhalten.
es_3YW4XOSQKSY1KVY416YBTCF3DNNU1Z	weiß :: Verhindert, dass die Temperatur im Haus zu heiß wird.
es_3Z3ZLGNNSK75255271SP74XB4IV3QJ	weiß :: Weiß wäre die ideale Farbe, um die Temperatur im Haus für den Hund so kühl wie möglich zu halten. Die Wahl der Farbe könnte sich auf andere Aspekte auswirken, z. B. auf eine bessere Sichtbarkeit von Schmutz.
es_3Z7EFSHGNBRDO22XM8YIUFXY74HCXL	weiß :: Die beste Farbe ist eindeutig weiß. Dies verhindert nämlich eine übermäßige Überhitzung, um Verbrennungen zu vermeiden, da Weiß die Lichtteilchen ablenkt und weniger überhitzt.
es_3Z7ISHFUH280HUCZ6E6YPEHQPAL8ZT	weiß :: Die einzige Auswirkung von weiß ist, dass es in allen Tests eine niedrigere Temperatur als die anderen Tests beibehält, da es eine helle Farbe ist und die Helligkeit dazu führt, dass es die Temperatur reflektiert und nicht eine hohe Temperatur erreicht.
es_3Z7VU45IP0UI6USE7TXJA4UIHVZZ18	weiß :: Die weiße Farbe sorgt dafür, dass die Temperatur im Inneren des Hauses nicht zu hoch ist, da sie das Licht reflektiert.
es_3ZPPDN2SLX92K44DFJYZ40BJTS39EU	gris claro :: Claro Grau
es_3ZSANO2JCHKCVX08J0IW3D19T52FSW	weiß :: Je dunkler die Farbe, desto wärmer wird die Umgebung für die Hundehütte. Wird eine helle Farbe wie weiß verwendet, heizt sie sich weniger auf, da sie die Sonnenwärme besser reflektiert.
es_3ZSY5X72NZOU0VDO3E1H0X5RVV3ROD	hellgrau :: Nach den Ergebnissen des vorangegangenen Experiments gilt: Je dunkler die Farbe, desto wärmer ist das Objekt. Hellgrau scheint mir eine geeignete Farbe zu sein, da das Objekt theoretisch eine gleichmäßige Temperatur haben würde.
es_3ZV9H2YQQFKAM21OJARVZTFXSMO3W5	weiß :: Weiß ist die Farbe, die am wenigsten Energie absorbiert und daher die niedrigste Temperatur im Inneren des Zwingers erzeugt.
es_3ZWFC4W1UWK0UI0V4BIRD3WD37ERFJ	weiß :: Es ist wissenschaftlich erwiesen, dass weiß 22% weniger warm ist als schwarz, daher wäre es die am besten geeignete Farbe für die Hundehütte, da sie sie so kühl wie möglich hält.
es_3ZWFC4W1UWK0UI0V4BIRD3WD3V9RFQ	Dunkelgrau :: Dunkelgrau ist die beste Wahl, es hält den Hund warm, aber nicht zu warm wie Schwarz. Letztendlich hängt alles vom Klima ab. In einem heißen Klima ist weiße Farbe die beste Wahl, in einer kalten Umgebung sind Schwarz oder Dunkelgrau die besten Optionen.
