id	text
es_308Q0PEVBAQE096ZB2OQPF9BDIFI93	Ich müsste wissen, wie viel Essig in den Behältern verwendet wurde und vielleicht auch die Raumbedingungen (z. B. Luftfeuchtigkeit). Ich müsste auch wissen, welches Instrument zur Bestimmung der Masse verwendet wurde.
es_30LB5CDZNENIZ57WBATJWZB8AAAZ0Y	Es wäre interessant, die Dichte des Materials zu kennen, die Temperatur, bei der das Experiment durchgeführt wurde, und eine Kontrollgruppe mit nur Wasser einzubeziehen, um sie mit dem Wasser mit Essig, also dem sauren Wasser, zu vergleichen.
es_30ZX6P7VFA8ZV0568BUBRTGXN4EJ21	Essigkonzentration, Temperatur und Art des Essigs
es_3137ONMDKIIHZERLTP49WHX6SNOEGB	marmol
es_31LM9EDVON5VKMUZUUSVJHJV3MFNJL	1. ich müsste wissen, welche Art von Holz, Kunststoff usw. für das Experiment verwendet wurde. 2. Ich müsste wissen, welchen Essig die Schülerin oder der Schüler verwendet hat3. Ich müsste wissen, ob sich die Anfangsmasse auf die Endergebnisse auswirkt, um zu wissen, ob ich die gleichen Anfangsmassen verwenden muss.
es_31LM9EDVON5VKMUZUUSVJHJVVCBJNL	1. zusätzlich zum Essig benötigen wir ein weiteres saures Referenzmedium, um die Reaktion der Materialien auf Essig zu messen. Es wird empfohlen, Zitronensaft zu verwenden, da es sich um ein saures Medium handelt, das sicher zu handhaben ist. Testen wir die gleichen Materialien in Zitronensaft wie in Essig. \n2. Wir brauchen ein neutrales Referenzmedium, um den Einfluss von nicht-saurem Regen auf die Materialien zu messen. Hierfür kann Leitungswasser verwendet werden. Der pH-Wert kann gemessen werden, und falls erforderlich, kann etwas Säure oder Hydroxid zugegeben werden, bis der pH-Wert neutral ist. Geben Sie Proben dieser vier Stoffe in neutrales Wasser, so wie Sie es mit Essig und Zitronensaft gemacht haben. Eine Angabe, die benötigt wird, um die Beständigkeit des Materials gegenüber saurem Regen zu messen, ist der Prozentsatz des Abbaus gegenüber dem sauren Medium, d. h. die Endmasse abzüglich der Anfangsmasse, wobei die Differenz durch die Anfangsmasse geteilt und mit 100 multipliziert wird. Um eine korrekte Messung der Masse zu gewährleisten, wird empfohlen, eine Handwaage anstelle einer elektronischen Waage zu verwenden.
es_31Q0U3WYDRSZMKM8OY50JK1J18B71J	Verwenden Sie eine hochpräzise Waage für genaue Messergebnisse. \Für Materialien wie Kalkstein oder Marmor sollten nicht zu kleine Proben verwendet werden, da sie sich bei Kontakt mit Essig nach 24 Stunden vollständig auflösen können. Zum Trocknen sollten die Proben in einer trockenen Umgebung ruhen, um die Wiederaufnahme von Feuchtigkeit zu vermeiden.
es_31Q0U3WYDRSZMKM8OY50JK1J19S712	Ich bräuchte mehr Proben, ihre Ausgangsmasse und die Differenz zwischen den Massen.
es_31Q0U3WYDRSZMKM8OY50JK1J1IW71O	Die Gruppe sollte die Art des verwendeten Holzes und Kunststoffs angeben, da es verschiedene Holzarten von verschiedenen Baumarten und Kunststoffe mit unterschiedlicher Elastizität (wie PVC) gibt. Die Temperatur der Umgebung muss angegeben und kontrolliert werden, damit das Experiment wiederholt werden kann. Auch die Marke des Essigs muss angegeben werden.
es_31QNSG6A5T6HXK6TNJEFYUORPHQ78S	Um das Experiment zu wiederholen, müsste ich die Umgebungsbedingungen kennen, unter denen das Experiment durchgeführt wurde.nIch müsste auch die Art des im Experiment verwendeten Essigs (Säuregehalt) kennen.nIch müsste auch die Art des verwendeten Probenmaterials kennen. Der verwendete Kalkstein könnte beispielsweise aus einem anderen Anteil an Mineralien bestehen, so dass die Ergebnisse unterschiedlich ausfallen könnten, ebenso wie die Verwendung einer anderen Art von Holz oder Kunststoff usw.
es_31Z0PCVWUMS0V4YHQHPAPQKET7DT7L	Der Schüler sollte das Gewicht der Probe vor dem 30-minütigen Absetzen und Trocknen messen und das Gewicht erneut messen, nachdem die Proben 30 Minuten lang abgesetzt und getrocknet sind.
es_31Z0PCVWUMS0V4YHQHPAPQKEYRV7TQ	Das Experiment ist vollständig und erfordert keine zusätzlichen Informationen. Die zusätzlich durchzuführenden Tests wären eine Tara der extrahierten Flüssigkeit und eine Verdünnung der extrahierten Flüssigkeit, um zu überprüfen, ob das korrodierte Material vorhanden ist.
es_320DUZ38G9ZPAUDD7QF0TXAYUSNJGV	Es wäre notwendig, die Größe des Behälters und das Material, aus dem er besteht, sowie die Menge des verwendeten Essigs zu kennen.
es_320DUZ38G9ZPAUDD7QF0TXAYYTGGJR	Menge des Essigs, Temperatur des Essigs, Masse der Proben
es_32AT8R96GNM1EFXYEPDVPD2C8JRUS7	Wie viel Essig wurde den einzelnen Proben zugesetzt; wo wurde der Essig auf die Proben aufgetragen; weisen die Proben Lacke oder fertige Oberflächen auf, die die Reaktion mit Essig beeinträchtigen könnten?
es_32RIADZISUH2XH3JZJMDC94I3YQS4J	Die Menge des hinzugefügten Essigs, die Frage, ob die Proben im Dunkeln gelassen oder dem Licht ausgesetzt wurden, geben die Art des Holzes, des Marmors, des Kalksteins und des Kunststoffs an, die für den Versuch verwendet wurden.
es_32SCWG5HIJHJZCR5QQBYE2JL9RW6PE	Einige wichtige Informationen sind die Art des verwendeten Essigs, die Menge des Essigs in jedem Behälter und die Temperatur zum Zeitpunkt des Experiments.
es_32SVAV9L3HMDFPYLI5V3H4I601DA3P	Saurer Regen entsteht durch das Zusammenwirken bestimmter Gase, die von der Industrie in die Luft abgegeben werden (z. B. Schwefeloxid und Distickstoffoxid), mit Regentropfen, die in die Atmosphäre fallen. 1) Da es mehr als eine Substanz gibt, die einen solchen sauren Regen erzeugt, ist es zweckmäßig, das Experiment mit mindestens einem zweiten sauren Mittel zusätzlich zum Essig durchzuführen. Dieses Mittel könnte der Saft einer Zitrone sein, der ebenso sauer ist wie Essig und sicher zu handhaben. Proben der gleichen Materialien können dann in Zitronensaft eingelegt werden, und das Experiment und die Messungen können wiederholt werden. 2) Man braucht auch ein pH-neutrales Element (wie Wasser), um den Einfluss eines sauren Milieus auf die Oberflächen mit dem Einfluss eines neutralen Milieus zu vergleichen, also kann man Proben der Materialien nehmen und sie in Behälter mit Wasser legen, so wie man es mit Essig und Zitronensaft gemacht hat. 3) Eine weitere nützliche Angabe aus dem Experiment ist der tägliche Prozentsatz des Abbaus, der sich aus der Differenz zwischen der Anfangsmasse jedes Objekts und der Endmasse ergibt, die dann durch die Anfangsmasse geteilt und mit 100 multipliziert wird. Da der Zeitrahmen des Experiments 24 Stunden beträgt, wäre dieser Prozentsatz ein Tageswert. (4) Tritt bei den in Wasser getauchten Gegenständen ein Massenverlust auf, so könnte dies darauf hindeuten, dass die Luft am Versuchsort leicht sauer ist, und der Säuregrad könnte durch Vergleich mit dem Säuregrad der anderen Stoffe gemessen werden. 5. Es ist wichtig, dass die Masse der Proben so weit wie möglich mit einer Handwaage und nicht mit einer elektronischen Waage ermittelt wird.
es_32UTUBMZ7I92A85W8T15VAUV9E8VB5	Wir benötigen die Dichte jedes getesteten Elements. Menge des in jeder Probe verwendeten Essigs, ausgedrückt in Volumen. Fläche oder Oberfläche des verwendeten Behälters,
es_32Z9ZLUT1NXHB1ZL79PNMT3L8PCOHQ	Ich müsste wissen: - Art des Essigs, ob es sich um Wein, Apfel usw. handelt - Prozentsatz der Säure im Essig - Art des destillierten Wassers, Prozentsatz der Reinheit - Material der Behälter - benötigte Liter Essig und destilliertes Wasser - Art des Holzes und des Kunststoffs.
es_32ZKVD547H0IYZ3DOJVZCF2CIJU3B9	Ich sehe, dass du in dem Experiment sehen willst, wie die Materialien auf den Essig reagieren und wie viel davon sich auflöst. Ich denke, das Experiment ist sehr klar, vielleicht sollten Sie angeben, welche Größe des Behälters erforderlich ist, obwohl, solange die 4 Behälter gleich sind und die Probe passt, sollte es genug sein. Es wäre auch gut zu wissen, wie viel Essig man hinzufügen muss. Da die Maße nicht angegeben sind, gehe ich davon aus, dass die Menge in allen Behältern gleich ist und dass sie ausreicht, um die Probe zu überschwemmen. Könnten Sie schließlich angeben, mit wie viel destilliertem Wasser die Proben gespült werden sollen und wie lange.
es_333U7HK6IBSMYA3M50ESNC71PPZDJT	Nach dieser Tabelle, vier verschiedene Proben und ihre Massen in diesem Abschnitt die höchste Masse ist Holz ist 0,0 und die niedrigste ist Kalkstein ist -1,3 ist sehr niedrig und die gesamte Tabelle ist Kunststoff ist -0,1 und mormol ist -0,4, so dass die gesamte Tabelle enthält die Masse.
es_336KAV9KYS5PQP05UBVE1GVLZ7QY2A	Um dieses Experiment zu wiederholen, müsste man die Holzart kennen, insbesondere wenn ein Holzlack verwendet wurde. Eine zusätzliche Messung sollte das Gewicht der feuchten Probe anzeigen, entweder in der Essiglösung oder auf einer Waage unmittelbar nach der Extraktion.
es_336YQZE83XRHV5UETR915SBQ9DJM50	Menge des hinzugefügten Essigs, Konzentration des verwendeten Essigs, Art des verwendeten Kunststoffs, Art des verwendeten Holzes, Beschaffenheit des verwendeten Marmors und Kalksteins, Menge des zum Spülen verwendeten destillierten Wassers, Spülzeit, Material des Behälters, in den die Proben gegeben werden.
es_338JKRMM28CS9X5KXQK5LYJGKREHAT	Menge des auszugießenden Essigs, Raumtemperatur, Material des Behälters, Trocknungstemperatur
es_338JKRMM28CS9X5KXQK5LYJGQI0AHW	Ich müsste wissen, wie viel Essig ich in die Proben geben soll, wie viel destilliertes Wasser ich verwenden soll, ob ich die Proben vor dem Wiegen mit einem Handtuch abtrocknen soll, welche Art von Holz, welche Art von Kunststoff, welche Art von Essig und welches Material der Behälter haben soll.
es_33CID571066UB8PPFWKTQIYH2C23LW	Volumen, Dichte
es_33CID571066UB8PPFWKTQIYH3ACL3L	Ich brauche ein Gewicht, Essig und destilliertes Wasser, um das Experiment zu wiederholen.
es_33F859I568QXS7AC34K1G93M1PNHB7	sehr gut trocknen lassen, wobei die Temperatur zu berücksichtigen ist
es_33FBRBDW6QCN911PE0MQEGG5GRR8CK	verschiedene Materialien haben unterschiedliche Dichten
es_33JKGHPFYE7LLU0KXR5NZ9BC98QMNQ	eine Studie über die chemischen Eigenschaften jedes untersuchten Materials durchführen.n Es ist notwendig, in anderen Arten von Lösungsmitteln wie Alkohol, Wasser, u.a. zu testen.n mit anderen Methoden wie Mazeration, u.a. testen.
es_33LK57MYLVII0ER8KCC365HRBJAZS6	Wie viel Essig soll in die Behälter gegeben werden? Welche Art von Essig soll für das Verfahren verwendet werden? Sollen die Behälter abgedeckt werden? Bei welcher Temperatur sollen die Proben stehen gelassen werden?
es_33NF62TLXLFUCG9WXH0FRP2R7PNKJK	Bestimmen Sie die Masse jeder Probe, befeuchten Sie nach 24 Stunden jede Probe mit destilliertem Wasser und beschriften Sie die Behälter.
es_33OOO72IVJY67LTDHYXL5CCS5S2TC7	Die Menge des Essigs in jedem Behälter, die Umgebungstemperatur und die Temperatur des destillierten Wassers, das zum Spülen jeder Probe verwendet wurde.
es_33PPO7FECXSQ3ZJGNITSBBS141VDIC	Welche Art von Holz wurde für das Experiment verwendet? \Welcher Kunststoff wurde für das Experiment verwendet (weich oder hart)? \Wo wurden die Probenbehälter gelagert (Temperatur, heller oder dunkler Ort)?
es_33PPO7FECXSQ3ZJGNITSBBS14OCID8	Ich müsste die Menge des Essigs, den Säuregehalt des Essigs und das Material der Behälter kennen.
es_33PPO7FECXSQ3ZJGNITSBBS1CSDDIK	Menge (in ml) des Essigs, der auf die Proben gegossen wurde, Informationen über die Art des Behälters, in den die Proben gelegt wurden, und genaue Informationen über die Bedingungen, unter denen die Proben bearbeitet werden (Druck, Atmosphäre und Temperatur), und natürlich eine Waage zur Berechnung der Masse der Proben.
es_33PPO7FECXSQ3ZJGNITSBBS1FDQIDB	Wie viel Essig sollte verwendet werden?n Wie viel Probenmaterial sollte verwendet werden?n Wie lange sollte die Probe gespült werden? n Sollte die Probe jeweils 30 Minuten lang getrocknet werden?
es_33TIN5LC06N0Q9L4FKATB33Z3PN9YM	Wie viel Essig muss man in die Behälter geben? Welche Art von Essig muss man in die Behälter geben? Wie trocknet man die Probe, wenn sie nach 30 Minuten noch feucht ist?
es_34HJIJKLP79IP9KNTERINWOP1LX4VE	Um das Experiment zu wiederholen, würde ich Folgendes hinzufügen:- ein Gewicht, um die Proben vor und nach dem Experiment genau zu messen- die Form der untersuchten Proben zu beschreiben- die spezifische Essigmenge zu bestimmen, die in jedes Gefäß gegeben werden muss, so dass jede Probe die gleiche Menge enthält- zu erwähnen, warum diese Proben ausgewählt wurden und was das Ziel ist.
es_34HJIJKLP79IP9KNTERINWOP8AFV48	1.2 - Nimm vier Behälter mit der gleichen Portion oder Größe.n2.2 - Achte darauf, dass die Essigportion in allen Behältern die gleiche ist.n2.3 - Nimm vier Proben von verschiedenen Holzarten, die wir als Material bezeichnen.
es_34J10VATJHBKS8NLS4ZCBAZ0QAGIQ9	Man müsste wissen, wie viel Essig verwendet wurde, ob von der Probe eine Restmasse übrig geblieben ist und welche Utensilien zur Durchführung dieses Experiments benötigt/verwendet wurden (berücksichtigen Sie auch die Porosität jeder Probe und ob sie vollständig trocken ist).
es_34S6N1K2ZXW95GWOUH9VUCZRGO8LHI	Ich muss wissen, wie viel Essig ich in jeden Behälter geben muss, welche Art von Essig, wo die Probe 30 Minuten lang trocknet.
es_352YTHGROXQD78P3OPAE8VXG21I4HJ	Damit das Experiment erfolgreich und genau ist, sollte den Behältern mehr Bedeutung beigemessen werden. Bechergläser, zum Beispiel, denn wenn sie aus verschiedenen Kunststoffen bestehen, könnten die Daten irreführend sein.
es_358010RM5G69NB8XDPTNK7LNY0WVXM	Für das Experiment wird in erster Linie eine Liste von Werkzeugen benötigt. Außerdem muss sie genau wissen, wie viel Essig in den Behältern verwendet wird, und sie muss wissen, wie man die Masse der Proben misst, um das Experiment wiederholen zu können.
es_358UUM7WR1GNFPLPMSKFPBJW5JWR7G	ist es notwendig, zusätzlich zu wissen, 1.- welche Art von Holz verwendet wurde. 2.- die Dichte des Essigs. 3.- die Temperatur, der die Proben ausgesetzt waren,
es_358UUM7WR1GNFPLPMSKFPBJW8E27RV	1. die Menge des Essigs 2. eine Waage 3. wie man die Materialien trocknet
es_358UUM7WR1GNFPLPMSKFPBJWE007R7	Wie hoch ist der pH-Wert von Essig? Welche Form haben die Proben? Gibt es eine Kontrollgruppe?
es_35GCEFQ6I71EGX6TUXB2YX9FI233Z7	Menge des in jedes Behältnis einzufüllenden Essigs, Größe oder Gewicht der zu verwendenden Proben und Bedingungen, unter denen die Behältnisse zu stehen haben.
es_35H6S234SCDF629M6B2KGWE4Q0656S	despises ed leer aal verfahren Del Gruppen, beschreiben Que Informationen zusätzliche Notwendigkeiten para Replik Experiment
es_35USIKEBNTTJWRFSABY6ADEQEZH6NJ	1. die Behältergröße. \n2. Menge des Essigs, die in jeden Behälter gefüllt wird. \n3. So bestimmen Sie die Masse. \n4. Welche Art von Material. \n5. Größe und Form der einzelnen Proben.
es_369J354OFFNDMZY6N7LBKT5TD72G6W	Die neue Ruhezeit der Teige und die Trocknungszeit der Teige sowie die Menge des zu verwendenden destillierten Wassers sind vom Hersteller zu bestimmen.
es_36PW28KO419GPNEI7PCZ0VM3TDPAEE	Sie müssen wissen, wie viel Essig Sie der Probe hinzufügen müssen. Außerdem müssen Sie wissen, wie viel Probenmaterial Sie einfügen müssen.
es_36U2A8VAG3CK754VJH1I1CHFJOMKYT	1. die Menge des in die Behälter einzufüllenden Essigs 2. Wie groß wird die Menge der Proben sein? 3. Ist sie luft- oder sonnengetrocknet?
es_36U2A8VAG3CK754VJH1I1CHFMMQKYW	Umgebungstemperatur (wenn das Ergebnis dadurch beeinflusst werden kann)n2. Wo sollen die Proben zum Trocknen aufbewahrt werden? 3. Die Temperatur des destillierten Wassers
es_36V4Q8R5ZMD6ORDCDJX4336H4ACQMO	-Welche Menge Essig wurde in jeder Probe zugeführt. \Kunststoffe haben verschiedene Arten, es ist wichtig zu wissen, welche Art von Kunststoff in diesem Experiment verwendet wurde. Welche Art von Essig wurde für das Experiment verwendet.
es_36WLNQG781NL8XJAD3CVV669IV7EBH	Um das Experiment zu wiederholen, muss man die Art des verwendeten Holzes, die Art des verwendeten Kunststoffs und die Menge, Art und Konzentration des verwendeten Essigs kennen.
es_36ZN444YTTBH7WA5DR78M540GY5IOR	Angaben über den geografischen Standort des Versuchs (Höhe über dem Meeresspiegel) nVerwendete Essigmenge nUmgebungstemperatur
es_373ERPL3YQLADNIWZVNGU7BE4HLTR4	hora exacta de cada recipiente y que tipo de materiales utilizaron pexact time of each container and what kind of materials they used to create this experiment, how many of the elements usednara crear este experimento apaorte de la cantidad de cas elemento utilizad
es_379J5II41QTXL65M4G1P992EU64LES	1) Zunächst müsste ich wissen, welche Menge Essig Sie für die einzelnen Proben verwendet haben und ob es für die verschiedenen Materialien die gleiche Menge ist.   2. ich würde auch gerne wissen, welches Instrument Sie zur Messung der Masse verwendet haben.   3. schließlich möchte ich wissen, aus welchem Material die Probenbehälter, in denen Sie die Proben zusammen mit dem Essig aufbewahrt haben, bestehen (Glas, Aluminium, Kunststoff usw.)
es_37FMASSAYE4XO2LW9M2MGL4110FBI3	Um das Experiment zu wiederholen, müssten wir wissen, welche Art von Kunststoff verwendet wurde, da es viele verschiedene Arten von Kunststoffen wie PVC, LDPE (in Plastiktüten) usw. gibt. Die verschiedenen Kunststoffarten reagieren unterschiedlich auf Essig. Die Temperatur, bei der das Material getrocknet wird, muss dieselbe sein. Es muss festgelegt werden, ob sie im Freien, in einem temperaturgeregelten Raum oder in einem Kühlraum aufbewahrt werden soll. Ich würde nicht empfehlen, im Freien zu arbeiten, da dies eine Variable wäre, die außerhalb der Kontrolle der Gruppe liegt. Sie müssen auch festlegen, wie lange die Proben unter destilliertem Wasser bleiben sollen. Kurz gesagt, Sie müssen mehr kontrollierte Variablen angeben, wie z. B. die Temperatur, die Art der Materialien und die Zeit, die sie unter destilliertem Wasser liegen.
es_37Q970SNZGLL5I60C13BEBXFSY9S14	Geben Sie zunächst die Abmessungen (Maße) der Proben an. \Zweitens: Geben Sie das Fassungsvermögen der Behälter an, in die die Proben eingetaucht werden sollen. \Drittens: Geben Sie die Menge des zu verwendenden Essigs an (ob die Proben vollständig mit Essig bedeckt werden sollen).
es_37Q970SNZGLL5I60C13BEBXFY431SP	1. welche Art von Essig zu verwenden ist.n2. Welche Art von Kunststoff zu verwenden ist.n3. Messungen der Probe, der Oberflächen, um sicher zu sein, dass die Oberfläche, auf die der Essig einwirkt, dieselbe ist.
es_37TRT2X24S4TJD52R4NMSMJ1HJZJBT	Es ist zu erkennen, dass Holz am wenigsten Masse verloren hat, obwohl es von Natur aus porös ist, verglichen mit dem Kalkstein, der sich durch die Lösungsmittel aufgelöst haben könnte, was die Abnahme seiner Masse erklären würde. Der Massenverlust des Kunststoffs war vernachlässigbar, möglicherweise aufgrund eines Messfehlers oder weil sich das Material verschlechterte und ein Teil davon in den Lösungsmitteln verloren ging.
es_37TRT2X24S4TJD52R4NMSMJ1OFJJBC	Dichte
es_37UQDCYH6Z8F8W26VCPPQ88ZRBHV7U	Dies könnte durch die Messung des Gewichts von sieben verschiedenen Elementen mit einer wissenschaftlichen Waage nachgestellt werden. In sieben Bechern können Materialien wie Stoff, Gummi, Pappe, Glas, Aluminium, Stein und Keramik eingefüllt werden. Etikettieren, Essig hinzufügen und verschließen. 42 Stunden lang einweichen lassen. Nach 42 Stunden spülen Sie die Materialien mit destilliertem Wasser ab und lassen sie anschließend vollständig trocknen. Messen Sie mit einer wissenschaftlichen Waage erneut das Gewicht der Materialien und tragen Sie die Daten in eine Tabelle ein. Berechnen Sie die Differenz zwischen den Massen (g).
es_37WLF8U1WR3IOLUPDY6QILXMJG66KV	CAliza
es_37XITHEISYMTR6GLD9SQ5XBA9JERCH	Wie viel Essig in jeden Behälter gegeben werden soll. 2. Wie viel destilliertes Wasser verwendet werden soll. 3. Stellen Sie sicher, dass es sich bei der Probe um die ermittelte Probe handelt.
es_37XITHEISYMTR6GLD9SQ5XBABRACRG	Wie viel Essig man in den Behälter gibt
es_382M9COHEJS04WSGDUTQ0WYXZVRUED	Ich habe die Verfahren durchgeführt und sie waren einerseits effektiv, ich konnte destilliertes Wasser herstellen, aber ich konnte auch saures Wasser herstellen, ein Wasser, das als Kühlmittel für Insektenvernichter und für Batteriesäure verwendet werden kann.
es_38BQUHLA9YD33F0WY650EYBHR3PMOX	1. durchschnittliche Masse. 2. Bogenradius (m). 3. Abwurfhöhe (m)
es_38F71OA9GV99X2N3Z3MAR4232Q9MF1	Menge des Essigs, Größe der Probe, Menge des destillierten Wassers
es_38YMOXR4MWC9JLO62CPT6WRH2A0W68	Um das Experiment zu wiederholen, müsste ich wissen, wie viel Essig in den einzelnen Behältern verwendet wurde, wie viel destilliertes Wasser verwendet wurde, welches Gerät zur Bestimmung der Masse der Proben verwendet wurde und welche Methode zum Trocknen der Proben verwendet wurde.
es_38YMOXR4MWC9JLO62CPT6WRH2HO6WK	In welche Art von Behälter haben sie den Essig gegossen? Wenn sie das Material im Essigbehälter belassen haben, haben sie ihn an einem dunklen Ort, unter natürlichem Licht oder einer Lampe stehen lassen. Welche Art von Holz wurde für das Experiment verwendet?
es_38YMOXR4MWC9JLO62CPT6WRH7KWW6T	Nach 24 Stunden werden die Proben aus den Behältern genommen und mit destilliertem Wasser abgespült.
es_38YMOXR4MWC9JLO62CPT6WRHDXQ6WT	ÜBERPRÜFEN SIE DIE MENGE DER MISCHUNG, DIE TROCKNUNG UND DAS AUSSEHEN DES TEIGS.
es_392CY0QWG34D330NU7SZ87YVRBW4IU	TemperaturLuftfeuchtigkeitBehältermaterial
es_39GAF6DQWTD1XAN46W8GPYHMQRO1VG	Erstens, die Art und Größe des Behälters, ob er aus Glas, Kunststoff oder einem anderen Material besteht. Zweitens, die Menge oder der Liter Essig, der in jeden Behälter gefüllt werden soll, und drittens, wo er ruht, ob in der Sonne oder im Schatten, wenn dieser Faktor die Verdunstung des Essigs nicht beeinflusst, wenn er in der Sonne steht.
es_39GAF6DQWTD1XAN46W8GPYHMSPI1V8	Das Volumen der Proben, denn 10 Gramm Marmor haben ein kleineres Volumen als 10 Gramm Holz. Die Klasse oder der pH-Wert des Essigs, das Spülverfahren (Eintauchen oder nicht?), die Temperatur der Umgebung, in der die Proben stehen.
es_39GXDJN2OVRJ8A7P5HHV484U9QA8VE	Für eine genauere Berechnung müsste man wissen, ob das Holz vollständig trocken ist, und man müsste die Zusammensetzung des Kalksteins in Prozenten von Ton, Siderit und Hämatit bestimmen, die den Kohärenzgrad des Gesteins verändern würden. Auch die Widerstandsfähigkeit des Kunststoffs, denn je nach Zusammensetzung kann der eine widerstandsfähiger sein als der andere.  Die Ausgangsmasse sollte gleich sein.
es_39JEC7537WELKDX2MTX06U0DTYXVC1	Es wären zusätzliche Informationen über die Ölmenge, die in jedem der Behälter enthalten sein muss, die Dichte des Öls und das Volumen der Proben erforderlich.
es_39LNWE0K4W9CK1U29DJHLBWPRK4IU8	Zumindest müsste ich das Volumen jedes Behälters kennen, die Menge an Essig, die hinzugefügt werden muss, und ob diese Menge für jedes der Materialien konstant ist oder einen Anteil der Masse darstellt.
es_39LNWE0K4W9CK1U29DJHLBWPU9FIU0	1- warum sollten die Proben nach der Entnahme aus dem Behälter gewaschen werden, das könnte die Ergebnisse beeinflussen 2- sollten das Volumen und der Durchmesser jeder Masse identisch sein oder nicht 3- welche Art von Essig wird für das Experiment verwendet.
es_39OWYR0EPM49RJCHI6ALLZPA6KUFYQ	Essig wirkt sich bei einigen der oben gezeigten Materialien auf die Masse aus, bei anderen bleiben die Eigenschaften fast gleich, bei einigen ändert sich die Farbe, der Geruch und die Form, bei Kalkstein etwas.
es_39PAAFCODOD26UZD8FSQV40HFFOTVX	Um die oben genannten Vorgänge zu verbessern, geben Sie ein: 1) Die Menge des in die verschiedenen Behälter eingefüllten Essigs. 2) Die Art des verwendeten Essigs. Darüber hinaus würde ich auch 3) das Volumen der Massen berechnen.
es_39RP059MEJ6JKLBNU10E8EBIIGZBMX	Zusätzliche Informationen:1. Instrument zum Abspülen jedes Teigs. Behälter, in den die Teige gelegt werden.3. Teigmessgerät.
es_39U1BHVTDN4IULXUO5MKC98YPBCT3E	Die Menge des Essigs (im Verhältnis zur Masse des Gegenstands), die Größe des Behälters (im Verhältnis zur Masse des Gegenstands), das Material des Behälters.
es_39ZSFO5CAA98FCE8RV4HXCBP3AFJUS	Ich bräuchte die Menge des Essigs, die Größe der Behälter und die Größe der Proben.
es_3A1COHJ8NL8EQ9C50S0RP7DL2NHH84	Ich müsste die Menge des Essigs in jedem Behälter kennen. Sie müssen die Größe der einzelnen Behälter kennen. Dazu müssten Sie den Stichprobenumfang kennen.
es_3A1PQ49WVJUWF9SK17RCAXQDICF1HS	die Art des Essigs, die Menge des verwendeten Essigs, die Menge des verwendeten destillierten Wassers, usw.
es_3A1PQ49WVJUWF9SK17RCAXQDJ1H1H9	Die Essigsäure im Essig macht die Masse heller, greift aber das Holz nicht an.
es_3A1PQ49WVJUWF9SK17RCAXQDJBSH1K	1. Geben Sie an, wie viel Essig in jeden Behälter gegeben wird (vorzugsweise in ml).  2) Geben Sie an, mit wie viel destilliertem Wasser jede Probe gespült werden soll. 3) Wie läuft der Spülvorgang ab? 4) Die Größe und Form der Behälter?
es_3AAPLD8UCEUXOT4T3QBMG398BHMHT6	Geben Sie die Essigmischung, die Wartezeit und die Ruhezeit sowie das Abspülen mit Wasser an.
es_3ATTHHXXWC1415OXEIU45IVTL9AXII	Menge des Essigs, Raumtemperatur und Wasserkonzentration.
es_3ATTHHXXWC1415OXEIU45IVTQZLIXZ	Ich muss wissen, welche Art von Essig verwendet wurde und welche Art von Stamm verwendet wurde, denn je nach Holzart kann es mehr oder weniger Flüssigkeit aufnehmen. Wie viel Essig muss ich in den Behälter geben?
es_3AZHRG4CU6XHEC03Q3YASY6T2BM30F	No veo preguntas
es_3B1NLC6UG19LW5GB23KKQTWA5SLGPO	Um das Experiment zu wiederholen, müsste ich wissen, welche Art von Essig verwendet wurde, wie viel Essig in den einzelnen Behältern war und welche Art von Holz und Kunststoff verwendet wurde, da es verschiedene Arten von Holz und Kunststoff gibt und ihre Eigenschaften variieren. Es wäre auch gut zu wissen, in welcher Umgebung die Proben geruht haben (in der Sonne? bei Raumtemperatur? usw.).
es_3B2X28YI3YSHVIQV7LTXJIEWSB36BR	"Ich müsste wissen, welche Art von Behälter verwendet wird und wie groß er ist. Ich müsste wissen, ob die Behälter, in denen die Proben 24 Stunden lang aufbewahrt werden, mit einem Deckel verschlossen oder offen sind. Schließlich müsste ich auch wissen, zu welchen beiden Zeitpunkten die in der Tabelle angegebenen Größen ""Anfangsmasse"" und ""Endmasse"" gemessen werden und welches Messgerät verwendet wird."
es_3B3WTRP3DDFAPOSXMZ3Y2Z2UO4V29P	1. wiegt jede der vier Proben vor dem Aufgießen mit Essig, um die Ausgangsmasse zu erhalten. 2. Wiegen Sie jede der vier Proben nach dem Trocknen, um die endgültige Masse zu erhalten. Ziehen Sie die Endmasse von der Endmasse ab, um die Massenänderung jeder Probe zu erhalten.
es_3BDCF01OGZ7VRBMD4HDJGCUUEK0LY4	Um den Versuch zu wiederholen, werden Proben von Marmor, Kalkstein, Holz und Kunststoff mit dem gleichen Ausgangsgewicht wie im ersten Versuch benötigt. Füllen Sie Essig in vier Behälter, in die die einzelnen Proben gegeben werden.  Nach 24 Stunden werden die Proben entnommen und jeweils mit destilliertem Wasser gespült. Lassen Sie die Proben 30 Minuten lang stehen und bestimmen Sie dann die Masse jeder Probe.
es_3BF51CHDTXNW8K725ONCWS73C6L0H7	Wie hoch ist die Temperatur der Proben? Wie hoch muss die Kondensation für jedes Element sein? Wie lautet die Formel zur Bestimmung der Masse?
es_3BV8HQ2ZZYECC8L317T1O7UQK5SA68	Menge des EssigsMethode zur Bestimmung der Menge der einzelnen Materialien (welche Art von Holz? welche Art von Kunststoff? ...)
es_3BWI6RSP7IMY6LGK0M0FQ4KDVDEE75	Die Masse oder das Volumen des in die Behälter eingefüllten Essigs, die Differenz zwischen der Masse des Behälters mit Essig vor und nach dem Einfüllen der Probe sowie die für die Studie verwendeten Materialien.
es_3BXQMRHWK1BYGKKTUSH9D4367UAMUF	1) Bei welcher Raumtemperatur wurde der Versuch durchgeführt. 2) Temperatur und Trocknungsbedingungen. 3) Menge des verwendeten Essigs in ml. 4) Menge des zum Spülen verwendeten destillierten Wassers?
es_3BXQMRHWK1BYGKKTUSH9D4367VHMUO	Es wäre interessant, dieses Experiment nicht nur mit Essig, sondern auch mit anderen Substanzen wie Milch, Wasser oder Öl durchzuführen. Dann könnten wir feststellen, wie jede der oben genannten Proben in Abhängigkeit von der Substanz, der sie ausgesetzt ist, reagiert. Soweit wir aus diesem Experiment schließen können, wird Holz zumindest in seiner Masse nicht verändert, wenn es Essig ausgesetzt wird, und Kalkstein wird am meisten durch Essig verändert. Mit freundlichen Grüßen.
es_3BXQMRHWK1BYGKKTUSH9D436GLHMUD	Wie wird die Masse zu Beginn bestimmt (mit welcher Methode), wie wird die Masse der Proben am Ende bestimmt, welche Größe und Zusammensetzung haben die Behälter?
es_3C2NJ6JBKCUVEQWRN9M3K0XEYZG2N9	Um dieses Experiment zu wiederholen, müsste man zunächst nur die Elemente austauschen, um andere Tests durchzuführen und Ergebnisse zu erhalten, die signifikante Veränderungen in ihrer Masse zeigen. Zunächst könnten wir Elemente wie Pappe, Plastik, Glas und Ziegelsteine verwenden, um Proben zu nehmen, die wir in Reagenzgläser geben (sie sind billig), denen wir Essig hinzufügen, um die Flüssigkeit, mit der das Experiment durchgeführt wird, nicht zu verändern, oder andere Flüssigkeiten wie Soda, Reinigungsflüssigkeiten (Clorox-Bleiche) und Regenwasser, um die unterschiedlichen Auswirkungen dieser Flüssigkeiten auf die einzelnen Materialien herauszufinden. Es ist auch wichtig, die Elemente für die Messung der Proben zu haben, die verwendet werden sollen, und somit die Anfangsdaten und die Enddaten zu haben. Es wäre ratsam, dieses Experiment an einem Ort durchzuführen, an dem niemand es bewegen kann und an dem die Temperatur nicht stark schwankt, so dass die Proben immer stabil sind und es keine großen Auswirkungen auf sie gibt, wenn die Ergebnisse überprüft werden. Dieses Verfahren muss, wie aus dem vorangegangenen Versuch ersichtlich ist, aufgebaut und 24 Stunden lang belassen werden, damit die Flüssigkeit auf das zu prüfende Material einwirkt.
es_3C44YUNSI32IKL6K0DJCK8TD1LOPDL	Zusätzliche Informationen erforderlich1. Holzart - es gibt mehrere Arten mit unterschiedlicher Dichte2. Säuregrad des Essigs - wichtig3. Menge des Essigs in jedem Behälter4. Die Behältnisse werden 24 Stunden lang abgedeckt oder offen gelassen.
es_3CFVK00FWNYT8RC7YYIRXLA1E006LX	MARMOL
es_3COPXFW7XDPQYRCUSU5ZOLO3JWQPK5	Behältergröße, Essigmenge und Umgebungsbedingungen (z. B. Licht und Temperatur).
es_3CTOC39K3936H12CENB6NKX5XN6J7S	Es ist notwendig, die Menge des Essigs, die Größe des Behälters und die Menge des verwendeten destillierten Wassers anzugeben.
es_3D3VGR7TA2S5E6K2KGHPCU7G1D83RE	- Aus welchem Material sollten die Behälter bestehen, sollten die Behälter während des 24-Stunden-Zeitraums abgedeckt werden, wie viel Essig sollte in jeden Behälter gefüllt werden, sollten die Proben vollständig mit Essig bedeckt werden und wie viel Essig sollte in jeden Behälter gegossen werden?
es_3D4CH1LGEC604I04LEON43WV7UD9GF	"Saurer RegenSaurer Regen ist eine Form der sauren Verschmutzung, die sich auf den Niederschlag (die Ablagerung) von Säuren in der Atmosphäre durch Regen, Nebel und Schnee (auch als nasse Ablagerung bezeichnet) bezieht.nDie wichtigsten Vorläufer von Säuren sind Schwefeloxide (SOx) und Stickoxide (NOx), die von Kraftwerken, Verbrennungsmotoren von Autos und Flugzeugen und einigen anderen Industriezweigen als Produkt der Verbrennung von Brennstoffen mit geringen Anteilen an Schwefel (S) und Stickstoff (N), wie Kohle, Erdgas, Gasöl, Erdöl usw., ausgestoßen werden.nSäuren, vor allem Schwefel- und Salpetersäure, lösen sich in den Wassertröpfchen, die die Wolken bilden, und in den Regentropfen selbst und lagern sich auf dem Boden ab. Beide Säuren entstehen in der Atmosphäre, wenn Schwefeltrioxid (SO3) und Stickstoffdioxid (NO2) mit Wasser, Sauerstoff und anderen vorhandenen Chemikalien reagieren. In Anwesenheit von Sonnenlicht erhöht sich die Geschwindigkeit der meisten dieser Reaktionen.n Es gibt noch eine andere Form der sauren Verschmutzung, die als trockene Ablagerung bekannt ist und sich auf saure Gase und Partikel bezieht, die vom Wind getragen werden und auf Gebäude, Autos, Häuser und Bäume treffen. Eine weitere Möglichkeit der Abschwemmung sind starke Regenfälle. In diesem Fall werden saure Stoffe in den sauren Regen eingebaut, was dazu beiträgt, seinen Säuregehalt zu erhöhen.nUngefähr die Hälfte der sauren Stoffe in der Atmosphäre fällt durch trockene Depositionsprozesse auf den Boden.nWie wird saurer Regen gemessen?nSaurer Regen wird anhand der ""pH""-Skala, dem Wasserstoffpotenzial, gemessen. Je niedriger der pH-Wert einer Substanz ist, desto saurer ist sie.nReines Wasser hat einen pH-Wert von 7,0, und Regen hat normalerweise einen pH-Wert zwischen 5 und 6, d. h. er ist leicht sauer, weil er Kohlensäure enthält, die sich bildet, wenn sich Kohlendioxid aus der Luft im fallenden Wasser löst. Im Gegensatz dazu hat der Regen in Gebieten, in denen die Atmosphäre durch diese säurebildenden Stoffe verschmutzt ist, pH-Werte von bis zu 4 oder 3, und in einigen Gebieten, in denen der Nebel sauer ist, kann der pH-Wert bis zu 2 oder 3 betragen, ähnlich wie bei Zitronensaft oder Essig.n Welche Auswirkungen hat saurer Regen?nDie durch saures Wasser verursachten Auswirkungen hängen von mehreren Faktoren ab, wie dem Säuregrad des Wassers, der chemischen Zusammensetzung des Bodens und seiner Pufferkapazität sowie den Eigenschaften der betroffenen Lebewesen.nDie Säureablagerung trägt zur Senkung des pH-Werts in terrestrischen und aquatischen Ökosystemen bei und ermöglicht die Mobilisierung toxischer Metalle, insbesondere von Aluminium. Dies hat eine Vielzahl von Auswirkungen, darunter Schäden an Wäldern und Böden, Fischen und anderen Lebewesen, Baumaterialien und der menschlichen Gesundheit. Saurer Regen beeinträchtigt auch die Sichtbarkeit.n In Wäldern verursacht saurer Regen Schäden, indem er Bodennährstoffe zersetzt und das natürliche Wachstum der Bäume behindert. Die Schäden können sich auf Weiden ausdehnen und das Vieh schädigen sowie auf Seen, in denen möglicherweise eine große Anzahl von Fischen getötet wird.n Die Auswirkungen des sauren Regens auf den Boden können in Wäldern in Hochgebirgsregionen verstärkt werden, wo der Nebel erhebliche Mengen an sauren Schadstoffen einbringt.n Der saure Regen trägt zur Zersetzung von Bau- und Kunstmaterialien (Steinkrankheit) und zur Metallkorrosion bei. Denkmäler und Gebäude reagieren empfindlich auf die Wirkung von saurem Regen. Viele Ruinen sind aufgrund dieses Faktors verschwunden oder stehen kurz davor.nDer Schaden für die Menschen ist hauptsächlich indirekt, durch den Verzehr von Fisch und Trinkwasser, das durch sauren Regen verunreinigt ist.nWie kann saurer Regen reduziert werden?nUm den sauren Regen zu reduzieren, muss die Emission der chemischen Verbindungen, die Säuren entstehen lassen, d. h. der Säurevorläufer, reduziert werden. Dabei handelt es sich hauptsächlich um Schwefeldioxid (SO2) und Stickoxide (Stickstoffmonoxid, NO, und Stickstoffdioxid, NO2).Heutzutage kann die SO2-Bildung durch die Entfernung von Schwefel aus fossilen Brennstoffen oder durch das Abfangen von SOx vor dessen Emission in die Atmosphäre durch chemische Reaktionen, die es in weniger reaktive chemische Spezies umwandeln, verringert werden. Durch den Einsatz von Katalysatoren wird die Bildung von NO und NO2 verringert, indem diese Oxide zu N2 und O2 reduziert werden."
es_3D8YOU6S9GXWRHZ17CASO86KHWA6U8	Ich müsste die Art der Verbindung kennen, die das Material des Experiments ist, um im Voraus zu wissen, welche Reaktion sie haben wird (z. B. ob es sich um eine Base, eine Säure usw. handelt, um zu wissen, ob es sich z. B. um eine Säure-Base-Neutralisierungsreaktion handelt). \Ich müsste die Essigmenge kennen, um sicherzustellen, dass die Reaktion innerhalb von 24 Stunden abläuft und dass das Lösungsmittel (in diesem Fall Essig) im Verhältnis zum gelösten Stoff nicht ausläuft.
es_3D8YOU6S9GXWRHZ17CASO86KIXA6UB	Wie viel Essig sollte in die Behälter gefüllt werden? \Wie oft sollten die Proben mit Wasser gespült werden? \Der Zustand der Proben: sind sie flüssig oder fest?
es_3DBQWDE4Y8BNDNFE5SO1I70QG345NW	Die Informationen, die nicht enthalten sind, sind die Zeit für jede Probe, 24 Stunden, das gleiche für die 30 Minuten und schließlich die Differenz.
es_3DBQWDE4Y8BNDNFE5SO1I70QLDT5NA	Anfangsdichte (Anfangsdichte)nEnddichte (Enddichte)nAnfangsvolumen (Anfangsvolumen)nEndvolumen (Endvolumen)
es_3DEL4X4EL8YQR532I0G7R6PHCWZXYO	Temperatur, Essigvolumen und Behältermaterial
es_3DH6GAKTY02FW03HJI4SOR5SIPKYZT	Um dieses Experiment zu wiederholen, müsste ich das Volumen jedes Materials sowie die Anfangs- und Endtemperatur jedes Materials kennen, und schließlich würde ich versuchen, ein anderes Probenmaterial wie Glas hinzuzufügen.
es_3DHE4R9OCYOP4YF50598UGOH2F1G2B	Die Temperatur, bei der die Proben aufbewahrt wurden, die Größe der Proben und die Menge des verwendeten Essigs müssen angegeben werden.
es_3DL65MZB8FS4I2BGR38Q6QCRRTECEA	Ich bräuchte die Größe der einzelnen Proben, denn nicht alle Materialien sind gleich, auch wenn sie ähnlich schwer sind.  Ich würde auch die Tageszeit benötigen, zu der die Proben in den Essig gelegt wurden. Ich glaube, dass es einen Unterschied zwischen den Messungen geben würde, ob es Tag oder Nacht war, da sie von der Temperatur beeinflusst werden können. Außerdem müsste ich wissen, zu welcher Jahreszeit das Experiment durchgeführt wurde, da Temperaturunterschiede während des Experiments eine große Veränderung bewirken können.
es_3DQQ64TANIYHTR6BH8O2CWIY193WPJ	Wie viel Essig sollte hinzugefügt werden, wie viel sollten die Behälter messen und wo sollten die Proben stehen?
es_3DY4FPOOA31PQFML4QNVVPZZUFPVRT	Wie viel Essig in jeden Behälter gegeben werden soll.
es_3DY4FPOOA31PQFML4QNVVPZZWQIRV6	Es ist wichtig zu wissen, ob die Proben in Essig getaucht werden müssen oder wie viel Essig verwendet wird. Eine bessere Beschreibung der Objekte wäre nützlich, da die Größe der Oberfläche der Objekte die Ergebnisse beeinflussen kann.
es_3DZQRBDBSNSHFLKFZ5HU24CCXAW3S7	Art und Material des Behälters; Waage; Menge des Essigs.
es_3E337GFOLBLLTK4YMO7SM4RFEJANGA	Menge des in jeder Probe verwendeten Essigs, n2. Temperaturen,n3. Zusätzliche Gewichte: a) der Behälter, b) der Materialien vor dem Spülen mit destilliertem Wasser und dem Stehenlassen.
es_3E47SOBEYS9GY7D2NMYHR5AJMCOCI5	Guten Morgen, wobei zu berücksichtigen ist, dass Essig eine chemische Zusammensetzung von Säure tro eine Reaktion zwischen den Materialien, die dem Experiment ausgesetzt sind, verursachen kann. 1) essig auf marmor. wie wir alle wissen, besteht marmor aus kalksteinfelsen, und wie wir alle wissen, was passiert, wenn wir einen felsen nehmen und ihm Wasser hinzufügen, zerfällt er. das gleiche passiert mit marmor, obwohl wir den Säuregehalt des essigs berücksichtigen müssen. und die Härte des Marmors, weshalb der Masseverlust nicht größer war, 2) im Hinblick auf die Kalksteinfelsen, wie ich bereits erwähnt habe, ist eine Rose anfälliger für Abnutzung, weshalb in den Proben ein größerer Verlust als bei Marmor zu verzeichnen ist. 3) Im Falle von Holz nimmt es bekanntlich Essig auf und die Masse nimmt zu, aber wenn man es ruhen lässt, kehrt es zu seiner ursprünglichen Masse zurück, wenn es austrocknet, so dass es keinen Unterschied zwischen der ursprünglichen und der endgültigen Masse gibt. 4) die praktische, weltweit eingesetzte, wie alle Materie in flüssigem Zustand gelagerte, litt auch unter einem kleinen und unbedeutenden Abnutzungsprodukt der Zeit, das in Säure des Vianders im Inneren des Behälters wirkte. Ich hoffe, dass Ihnen meine Meinung gut erschienen ist und ich hoffe, dass Sie sie positiv qualifizieren.
es_3E47SOBEYS9GY7D2NMYHR5AJNK9CI7	1. wie viel Essig verwendet werden sollte. 2. Die Größe der Behälter. Die Konzentration des zu verwendenden destillierten Wassers.
es_3EF8EXOTT38S6FNAP7UXMA6SWM11JG	Ich musste wissen: die Temperatur des destillierten Wassers, die Umgebungstemperatur während der 24 Stunden, ob die Behälter geschlossen oder offen waren.
es_3EJJQNKU9TIK8ER1Z16RGO8QJDIHRG	müssen wir erklären, wie die Ergebnisse aussehen und welche Zutaten wir benötigen.
es_3EJJQNKU9TIK8ER1Z16RGO8QRMBHRZ	Als man feststellte, dass jedes Material in den Behälter gelegt wurde, reagierte die Masse unterschiedlich, aber zwischen den beiden Arten stach das Holz hervor, da es keine Massenveränderung gab und es seinen großen Unterschied beibehielt.
es_3EJPLAJKEOTDDGTBDZ9050LZSKDZ6Z	Ich müsste die Größe des Behälters, das Material des Behälters und die Frage wissen, ob der Essig die Probe vollständig bedeckt (d. h. ob sie untergetaucht ist oder nicht).
es_3EO896NRAY8TFZZJRQE7SGPNTDPTJZ	Kalkstein
es_3ERMJ6L4D05WI98XHKOY3CPM2PLM70	Das Experiment kann mit denselben Materialien, aber bei unterschiedlichen Temperaturen (z. B. im Kühlschrank, in der Sonne usw.) wiederholt werden. Das Experiment kann mit denselben Materialien, aber mit unterschiedlichen Säuren (z. B. Zitronensäure, Sprudelwasser usw.) wiederholt werden. Das Experiment kann auch unter Beibehaltung derselben Säure, aber mit anderen Materialien (z. B. Eisen, Knochen, Fleisch - um biologische Materialien anstelle von physikalischen Materialien einzuführen usw.) wiederholt werden.
es_3ERMJ6L4D05WI98XHKOY3CPMA8L7MV	Wie viel Essig wird benötigt?
es_3EWIJTFFVQKKOAG0FNF6BPAQMQ2E0G	niemand
es_3F0BG9B9MR0WCQXB0NC9X7CT8V77Y8	Ich muss wissen, welche Temperatur die Materialien hatten, wie viel destilliertes Wasser verwendet wurde und welchen Reinheitsgrad es hatte und wie viel Essig verwendet wurde.
es_3F6HPJW4JFDL1K55FADQGJA5PYZ2WN	1. wie viel Essig wird für jede Probe benötigt 2. Material, auf dem die Proben getrocknet werden 3. Wie viel jede Probe wiegen muss
es_3FE2ERCCZZL9OIX9QMXSV25CUHMPOY	1- Essigmenge (kann die chemische Reaktion beeinflussen). 2 - Temperatur (kann die Trocknungszeit beeinflussen). 3 - Empfindlichkeit des zur Messung der Masse verwendeten Geräts (kann das Endergebnis des Experiments beeinflussen). 4 - Art des Behälters, in dem die Proben 24 Stunden lang gelagert wurden (Luft, Licht usw. können die chemische Reaktion beeinträchtigen).
es_3FE2ERCCZZL9OIX9QMXSV25CYCKOPP	Menge des zu jeder Probe hinzugefügten Essigs, Wiegen der Gefäße, bei welcher Temperatur die Proben stehen gelassen wurden.
es_3FE7TXL1LK0GHN9J31EKOUSJYAP2QD	Worum es sich bei den Proben handelt, wie viel Essig zu verwenden ist, wie man die Proben wiegt
es_3FE7TXL1LK0GHN9J31EKOUSJZFD2QC	Ich denke, dass die Tabellen mit einer besseren Bildqualität für die Leser ein wenig verbessert werden könnten.
es_3FIJLY1B6WHFI5KGRJE288WY5EGPFW	- Die Menge des Essigs in jedem Behälter. Sie besagt, dass die Behälter identisch sind, aber nicht die Menge des Essigs in jedem Behälter. Die Ergebnisse unterscheiden sich, wenn die Proben nicht mit destilliertem Wasser abgespült werden. Es gibt einen Unterschied, wenn die Proben auf einer saugfähigen Oberfläche liegen.
es_3FTF2T8WLTVW14Q40JS5Q6IJTY39W2	Die zusätzlichen Informationen, die benötigt werden, sind die Menge an Essig, die den Proben zugesetzt wurde, und eine Kontrollgruppe.
es_3FTYUGLFSWYERBO1GYAYM2OW08JD5J	Ich benötige folgende zusätzliche Informationen:- Welche Art von Essig wurde verwendet (es gibt verschiedene Arten von Essig, z. B. Apfelessig, Sherry-Essig usw.),- Aus welchem Material bestehen die Behälter?
es_3G5W44VEU9VKLEJVPBFCUCABASGKGB	Wie viel Essig, welche Proben und welche Art von Behälter?
es_3G5W44VEU9VKLEJVPBFCUCABE9UKGR	NACH DIESER TABELLE IST DER UNTERSCHIEDLICH HOHE WERT DER ENDMASSE PLASTISCH. SEIN WERT IST 0 UND DER KLEINSTE WERT BEI KALKSTEIN IST -0,01. DIE SCHLUSSFOLGERUNG AUS DIESER TABELLE IST ALSO, DASS PLASTIK SEHR SCHLECHT FÜR DIE GESAMTE UMWELT IST. PLASTIK IST ALSO EIN SEHR SCHLECHTES MATERIAL.
es_3GDTJDAPVWO0INDGRPG4HCLHBN98MH	Während des Experiments in den Daten habe ich festgestellt, dass Holz einen viel höheren Wirkungsgrad hat als die anderen, einschließlich Marmor.
es_3GGAI1SQEXB2UQ3T81W9JYH07VOCMP	Welches Material legen wir den Proben bei und warum verwenden wir dieses spezielle Material? Was bewirkt das Material bei den Proben? \Warum ändert sich die Masse der einzelnen Proben?
es_3GLB5JMZFZ8C78DLXUTPQZFLUMCGDX	Mit den gegebenen Daten ist es mehr als genug, um die Endmasse zu kennen und die Berechnung durchzuführen.
es_3GS6S824SSAHQ6UY1TBA87D33M1WN8	) Ich muss wissen, wie viel Essig ich zu jedem Teig hinzufügen muss. \n2.) Welche Größe oder Menge an Teig/Material sollte ich verwenden?) Wie lange sollte man es nach dem Abspülen mit destilliertem Wasser stehen lassen?
es_3GU1KF0O4KEP5O80MHS6PI5DOOBPBF	Müssen die Behältnisse während der 24 Stunden geschlossen oder geöffnet bleiben, müssen die Proben im Behältnis oder an anderer Stelle ruhen und wieder trocknen, und gibt es Umgebungstemperaturen, die zu berücksichtigen sind?
es_3HMIGG0U4NJ0C42UAS4FB78OKHV8YJ	Aus welchem Material wird der Container hergestellt? \Massen müssen gewogen werden
es_3HMVI3QICL5I14I9B7V0WXLGAZQY16	NACH DIESER TABELLE DIE ERGEBNISSE DER FORUMUESTRA SOLLTE MARMOR, KALKSTEIN HOLZ UND KUNSTSTOFF IN DIESEM HOLZ IST DAS HÖCHSTE NIVEAU DER MASSEN VON 0,00 UND DAS NIEDRIGSTE NIVEAU DER KALKSTEIN IST -1,3 AM MARMOR IST -0,4 UND PLASIC IST -0,01
es_3HRMW88U183I0Y8DWL3POXFZU9OM05	MADERA
es_3HUTX6F6VW0DWBW3OOMGZPXJK6T2OM	a) Was ist das Ziel des Experiments? b) Würden Sie verschiedene Säurelösungen verwenden? c) Weitere Kontrollproben mit verschiedenen Gegenständen, die mehr oder weniger säureempfindlich sind?
es_3HWRJOOET7FKPJ0COPYQLVG9EXZSEM	anfängliches Objektvolumen, endgültiges Objektvolumen, anfängliche Objektdichte, endgültige Objektdichte, Differenz der Dichten.
es_3HYA4D452TWJQYJAPL3QCVO5VVFF29	Verwendete Essigmenge Geben Sie an, ob es sich um handelsüblichen Essig oder um Essigsäure handelt (wenn ja, geben Sie die Konzentration an) Geben Sie an, ob der Essig an der Luft oder in einem Trockenofen getrocknet wurde.
es_3I7DHKZYGPDBPV2X745OA2RHEP45F1	1. die in jeden Behälter einzufüllende Essigmenge. 2. 2. die Art des Essigs. 3. die Art des Behälters, in dem das jeweilige Material untergebracht werden soll.
es_3IAEQB9FMGX84U3LCZX7C219OTOWD0	Wie groß ist das Stück, welche Art von Material und wie viel Essig sollte verwendet werden?
es_3IGI0VL649X9LXLWA7K0RD0HVWWNO0	Ich bräuchte den Typ oder die Marke des Essigs, den Gegenstand, der für jedes Material verwendet wurde, und wie stark das Material dem Licht ausgesetzt war.
es_3IHR8NYAM9E5KPNR72IJH4Z7GT9P4K	Wie hoch ist die Essigmenge, aus welchem Material bestehen die Behälter, wie hoch ist die Menge an destilliertem Wasser, wie wurde das Material getrocknet.
es_3ITXP059PYWS0ZM42Q9HIBT1IA2JSE	1) Wie viel Essig muss ich bei jedem Versuch zugeben? 2) Mit wie viel Wasser muss ich die Proben waschen, egal wie viel? 3) Während ich auf die 30 Minuten zum Trocknen warte, sollte ich sie bei welcher Temperatur stehen lassen? an der Luft oder in einem Raum?
es_3IX2EGZR7DWGZKMRN19CS1O53IFJRD	Menge des in jeder Probe verwendeten Essigs. Die genaue Art des Essigs oder der Säuregehalt des Essigs. die äußeren Bedingungen (Temperatur, atmosphärischer Druck). Die Größe der Oberfläche der Proben bzw. ihre Geometrie.
es_3IXEICO794WHR4KC77KIJCKIYJ46TK	Die Größe des Behälters und das Material, aus dem er besteht, sowie die Menge des verwendeten Essigs.
es_3J2UYBXQQNPGBVNL95W8Z1ID174603	Sie müssen wissen, wie viel Essig Sie jeder Probe hinzufügen müssen und ob die Essigmenge im Verhältnis zur Masse der Probe zu Beginn des Experiments stehen soll. Sie müssen auch wissen, was das Ziel des Experiments ist, damit Sie die Ergebnisse nutzen können, um Schlussfolgerungen zu ziehen; wahrscheinlich werden Berechnungen angestellt. Auch die Temperatur kann bei Experimenten eine wichtige Rolle spielen. Sie müssen die Temperatur kennen, bei der das ursprüngliche Experiment durchgeführt wurde, um die Ergebnisse korrekt wiederholen zu können.
es_3J88R45B2IBWIRB1RDKOEFW5D0NXP8	Ich müsste wissen, wie viel Essig ich in Verfahren 2 in den Behälter geben muss, ob der Behälter geschlossen oder offen gelassen werden sollte und schließlich müsste ich genau wissen, welche Art von Material, welche Art von Plastik, welche Art von Holz, ich für das Experiment verwenden sollte.
es_3JBT3HLQFAFLNMBGSV89B0CGEI5ZPK	Es soll festgestellt werden, wie viel Essig aufgetragen wurde, ob alle Materialien vollständig mit Essig bedeckt waren und wie die Materialien getrocknet wurden (ob sie an der Luft oder mit einem Fön getrocknet wurden).
es_3JBT3HLQFAFLNMBGSV89B0CGLP3PZT	Wie groß waren die Container.n2. Wie viel Essig wurde pro Behälter verwendet.n3. Wenn alle Proben die gleiche Oberfläche hätten.
es_3JCG6DTRV53X96B45C4LKCQMFIJQQ0	Art der verwendeten Muscheln, Essigkonzentration und -art.
es_3JCG6DTRV53X96B45C4LKCQMN95QQC	Um das Experiment zu wiederholen, muss ich zunächst wissen, wie viel Essig sie in jeden Behälter geschüttet haben. Zweitens muss ich die Größe und Form der verwendeten Behälter kennen. Ich müsste auch die Menge und die Temperatur des destillierten Wassers kennen, das zum Spülen der einzelnen Proben verwendet wurde. Ich bin mir nicht sicher, ob einer der oben genannten Faktoren einen Einfluss auf die Ergebnisse haben würde.
es_3JNQLM5FT6Z5QQT6BW6O78TPPXGL28	Wasser
es_3K3R2QNK8DGJ901Z5JD48IXM9ZAU95	Um das Experiment wiederholen zu können, müsste ich:\n1º die Temperatur des Raums kennen, da sie die chemischen Reaktionsprozesse beeinflusst. \n2º Die Masse des hinzugefügten Essigs zu kennen oder zumindest zu wissen, ob sie die Proben vollständig bedeckt haben oder nicht (es ist nicht klar). \n3º Die Beschreibungen der Proben sind vage, ein einfaches Wort, um es nachmachen zu können, müsste ich wissen, um welche Art von Kunststoff es sich handelt und welche Art von Holz es ist. Was Marmor und Kalkstein betrifft, so halte ich sie für ein einzigartiges und besonderes Material.
es_3KGTPGBS6ZY89GG0KAYPYVP83C62UT	Kalkstein
es_3KJYX6QCMBO8SR38WLEMTYD8IIXJVT	Es fehlen Angaben zur Essigmenge, um zu analysieren, wie viel Essig mit den ausgewählten Materialien reagiert hat.
es_3KKG4CDWKKBKS27KQDMMVEZS9KK94Q	Es war ein einmaliges Erlebnis zu sehen, wie ein Teig durch das Einlegen bestimmt wird.
es_3KOPY89HMAFOGI1PCB8GA3LPRSRJ37	Kalkstein
es_3KV0LJBBH4Y60SSCQYM48TGM79JMRN	Die Liste der Dinge, die zu Beginn benötigt werden, einschließlich der Angaben, woher sie bezogen werden können und wie groß sie sind. Was ist der Zweck des Experiments, was ist mit den Ergebnissen zu tun, welche Bedeutung haben die Ergebnisse und wie kann man sie im Alltag, bei Projekten oder im Beruf anwenden?
es_3L2IS5HSFCV4Y25T6TW9QJS6JCYUNS	NACH DIESER TABELLE SIND VIER SCHÜLERRAHMEN AUFGELISTET: A, B, C, D. DER SCHÜLER MIT DER HÖCHSTEN PUNKTZAHL IST B UND DER SCHÜLER MIT DER HÖCHSTEN PUNKTZAHL IST B UND JEDER SCHÜLER HAT EINE DURCHSCHNITTLICHE PUNKTZAHL VON C UND D. DIE STUDIE ENTHÄLT EIN ERGEBNIS FÜR DIE VERWENDUNG VON PLASTIK UND DAS HALTEN.
es_3L2IS5HSFCV4Y25T6TW9QJS6KCXUNS	Die Essigmenge, die in jedem Behälter enthalten ist, wird benötigt. Größe der Stichprobe. Die für das Spülen verwendete Wassermenge, so dass sie für alle gleich ist. Das zur Ermittlung der Masse verwendete Gewicht. Und schließlich: Wo wurde es zum Trocknen aufbewahrt?
es_3L6L49WXW2A1RF58NN95JYUQMPJ45D	Sie müssen wissen: Die Menge des verwendeten Essigs Die Art des verwendeten Essigs Die Art des verwendeten Behälters Die Zeit und die Art und Weise, in der die Probe gespült wurde
es_3L6L49WXW2A1RF58NN95JYUQWOT54W	1) Wie viel Essig geben Sie in jeden Behälter.n2) Welche Art von Essig verwenden Sie.n3) Größe der Behälter.
es_3L70J4KAZIZBXH0IBU1FUD4IX5ZDAB	IM VERGLEICH ZU DEN PRODUKTEN HÖHER IST ALS BEI HOLZ.
es_3LKC68YZ3CGZ8RUA28BNNWD8OJOWOA	Ich bräuchte Teig, 4 Gefäße, Essig und destilliertes Wasser, um das Experiment zu wiederholen.
es_3LKC68YZ3CGZ8RUA28BNNWD8OKEWO2	Temperatur der Umgebung, in der sie gelagert werden. Material des Behälters, in dem sie gelagert werden.
es_3LPW2N6LKVF08DZN2T0NW2SKMJMU54	Wie hoch ist der pH-Wert des Essigs? Welche Art von Waage wurde verwendet? Wie viel destilliertes Wasser wurde verwendet?
es_3LQ8PUHQFN57FFOI9ECI2W7Z3WJIHY	Nach 24 Stunden ist es dasselbe, lassen Sie sie trocknen, wiederholen Sie es jedes Mal.
es_3LRLIPTPESMJBN6S3BN2YQZ8KDFKAF	Menge des verwendeten Essigs, Menge des zum Spülen verwendeten destillierten Wassers und Art des Spül- und Trocknungsvorgangs, Form der Materialproben und spezifische Zusammensetzung der einzelnen Materialien.
es_3LRLIPTPESMJBN6S3BN2YQZ8L2CKAR	Um das Experiment zu wiederholen, müsste ich die Bedingungen des Ortes kennen, an dem die Proben gelagert wurden, die Menge des verwendeten Essigs, die Art des Gewichts und die Parameter, unter denen diese Proben ausgewählt wurden.
es_3LUY3GC631D23C5A90GQKGJHDNWP7R	Sie würden die gleichen Dinge verwenden, die auch für die Probe verwendet wurden.... Sie würden auch die gleiche Menge Essig verwenden, die Sie verwendet haben. Außerdem müssen Sie die Proben zur gleichen Zeit wie beim ersten Test entnehmen.
es_3LWJHTCVCEZ0IHLVRWTR8DM88TCQFY	Um das Verfahren zu wiederholen, bräuchte ich 4 weitere neue, saubere Behälter und 4 weitere Proben, die mit den im Verfahren verwendeten identisch sind. Ich müsste auch wissen, wie viel Essig den Proben im ersten Verfahren zugesetzt wurde, damit ich weiß, wie viel ich hinzufügen muss. Vielleicht würde ich nach dem anfänglichen Verfahren und der Bestimmung der Veränderungen der Masse jeder Probe die Veränderungen der Proben weiter beobachten, indem ich die Masse noch dreimal im Abstand von 30 Minuten bestimme.
es_3M0NZ3JDP3BHUCTX8GZVDU7ZVJRZ5V	marmol
es_3M1CVSFP62I5MQ4NGG7ZUCBHK9QAQX	Wie viel Essig ist einzufüllen nOrt, an dem die Proben 24 Stunden lang aufbewahrt werden, im Freien oder bei geschlossener Temperatur nGröße der Behälter nMaterial des Behälters
es_3M23Y66PO4KGC47XI7FS97OWYMM6S1	Wie viel Essig? Wie hoch ist die Raumtemperatur innerhalb von 24 Stunden? Wie hoch ist die relative Luftfeuchtigkeit im Raum innerhalb von 24 Stunden?
es_3M68NM076JK4BP7K3IFNJXJ0HJX6RA	Ich müsste die Temperatur und die Luftfeuchtigkeit der Umgebung kennen.
es_3MAOD8E57SNWF6ZOBY7WAQRAD13XNP	1. es ist notwendig, den empfohlenen Gefäßtyp zu kennen, da unterschiedliche Gefäßtypen die Endmassen verändern können. 2. Es wäre ratsam, die Masse der Ausgangsproben zu standardisieren, damit der Unterschied zwischen den Massen proportional ist. Bei den Messungen sollten mindestens 3 Dezimalstellen verwendet werden, da bei so kleinen Massen Daten entstehen können, die aufgrund von Rundungsproblemen verworfen werden. Es ist ratsam, die Art des zu verwendenden Essigs anzugeben, da natürliche oder synthetische Essige zu unterschiedlichen Ergebnissen führen können.
es_3MRNMEIQW7JST0RM8LQ53RKTLW2DLL	"Im Prinzip macht mich das Holz skeptisch. Wurde es mit irgendwelchen Chemikalien vorbehandelt? Denn wenn nicht, hätte es mehr Flüssigkeit aufnehmen müssen und somit seine Masse erhöht, da dies eine der Eigenschaften von Holz ist. Ich glaube nicht, dass 30 Minuten lang genug waren, damit das Holz die Flüssigkeit verdampfen konnte, und ich hätte einen größeren Unterschied feststellen müssen. Andererseits wäre es interessanter gewesen, das Experiment mit Proben durchzuführen, die die gleiche Ausgangsmasse haben. Auf diese Weise lassen sich die Ergebnisse besser vergleichen. Schließlich ist es wichtig, die Proben zu reinigen, da die Verwendung von Essig die Proben wahrscheinlich von Verunreinigungen ""befreit"" hat und deshalb nach dem Trocknen ein Unterschied festzustellen ist."
es_3MX2NQ3YCB7SPHTI7YBAG9ROFOP5X2	Ich würde gerne wissen, welche Art von Essig verwendet wurde, wie viel in jedem Behälter verwendet wurde und wie schnell der Essig in jedem Behälter gewirkt hat.
es_3N1FSUEFL7DWVSK12TROHAII07G4DN	Geben Sie die genaue Essigmenge an, die für jede Probe benötigt wirdTemperatur, bei der die Proben getrocknet werden sollen Ort und Temperatur für die 24-stündige Ruhezeit jeder der Proben
es_3N8OEVH1FT3R3IL8BMKD620MMDGOOA	Essigsorte, Essigkonzentration, Menge des verwendeten Essigs, Temperatur an verschiedenen Stellen, Wiederholung des Versuchs bei verschiedenen Temperaturen
es_3NAPMVF0ZYS6B544725EO3BOTKV72I	Ich wüsste nicht, wie ich antworten sollte.
es_3NC5L260MQZXX58FCJ1NJ8R8TBVFOI	Menge des zu verwendenden Essigs, Art des Essigs, Konzentration,
es_3NJM2BJS4YJ8FT060HO102BV93PPCR	Stellen Sie fest, wie stark der Behälter mit Essig gefüllt ist. Kann die Probe überprüft werden, ohne die Flüssigkeit zu stören, und lässt sich feststellen, warum einige Objekte mehr Masse verloren haben als andere. Aufgrund des Materials ?
es_3NKQQ8O390IVCQEGHZI6UEGCZJDDUQ	Madera
es_3NL0RFNU0H049YQBUADBLND8KAX4K8	Welches Instrument verwende ich zur Bestimmung der Masse? Aus welchem Material sollten die 4 Behälter bestehen? Wie viel Essig wird hinzugefügt? Welches Gewicht wird für jede Probe vorgeschlagen?
es_3NOKK93PR3LJF0VUNUELWECUES2EES	Für die Wiederholung des Experiments benötigen Sie mehr Plastik und Kalkstein.
es_3NOKK93PR3LJF0VUNUELWECUM2QEE8	Zugesetzte Essigmenge 2. Herkunft der Proben3. Art des verwendeten Behälters4. Bedingungen, unter denen es während der 24 Stunden aufbewahrt wurde (Temperatur, Druck)
es_3NPI0JQDAQIP1A2HM3JRPCBZTNVPT8	Um das Experiment zu wiederholen, müsste man die (genaue) chemische Zusammensetzung oder die Marke des verwendeten Essigs, die für jede Probe verwendete Essigmenge und die Zusammensetzung jedes der getesteten Materialien kennen.
es_3NVC2EB65SCEB7WOYB9JKQ0DCXX3YS	Die Menge des Essigs, die in jede Probe gegeben wurde, die Art des Behälters, in den der Essig gegeben wurde, und die Messung der Proben wären notwendig, um dieses Verfahren zu wiederholen.
es_3O7L7BFSHG2VV5XGJD4CHTAM4Y5EIL	Die Menge an Essig, die ich brauche. Die Menge des destillierten Wassers. Welche Art von Behältern.
es_3O7L7BFSHG2VV5XGJD4CHTAM509EIU	Welche Art von Behältern wird verwendet, welche Menge an Essig und welche Menge an destilliertem Wasser.
es_3OJSZ2ATDU9YA2NRPL7CMAE0FOY75L	Zu verwendende Sicherheitsausrüstung, Art des Behälters, ideale Trocknungsmethode
es_3OLQQLKKNU2RQGHM1VPCTUPMIL9EJT	Welche Probe kann am längsten im sauren Regen überleben? In diesem Fall hat Kalkstein den großen Unterschied von -1,3, so dass er nicht lange überleben kann, wenn er sich noch in einem sauren Klima befindet. Marmor und Kunststoff gelangen ebenfalls in den sauren Regen, schmelzen aber langsam. Holz ist die einzige Probe, die sich nicht verändert und in einem solchen Klima leben kann.
es_3OONKJ5DKEW7KOWZ7HFR0I0NJWTBOT	Brechungsindex des Essigs Konstante Temperatur Schwere der Fläche Luftfeuchtigkeit
es_3OS4RQUCRBSDEBJ68EW1DOR9LROBFF	Um das Verfahren zu wiederholen, müsste ich genau wissen, welche Art von Essig sie verwendet haben. Welcher Art von Licht sie ausgesetzt waren, d. h. wo sie sich befanden, da Licht und Klima die Ergebnisse beeinflussen können. Der letzte Punkt, den ich ebenfalls wiederholen können muss, ist die Art der verwendeten Probe. Grundsätzlich, woher die Proben stammen, insbesondere das Holz und der Kunststoff, da es verschiedene Arten von Holz und Kunststoff gibt.
es_3OSWBBLG1GANTU8BM4TTELFGW5PDXO	Form der Proben (sind sie in Blöcken, pulverisiert...), Art des Kunststoffs und des Holzes (es gibt mehrere Kunststoffe und das Holz kann von vielen verschiedenen Bäumen stammen), sind die Proben vollständig untergetaucht oder schwimmen sie (zumindest teilweise) und im Zusammenhang mit dieser letzten Frage: Volumen und Form des Behälters.
es_3OVR4I9USRWQK1O67FX8H9PHI1HQ4J	Ich brauche die 4 Proben. Ich muss wissen, wie viel Essig ich in jeden Behälter geben muss. Ich muss wissen, ob ich es in der Sonne oder an einem warmen Ort trocknen lassen soll.
es_3OWEPKL08BP20RTXTL3YGREM58QN7G	Menge des verwendeten Essigs, Art des verwendeten Behälters, ob es sich bei den Proben um ein Stück Material oder um mehrere Stücke handelt, die zusammen das Gesamtgewicht jeder Probe ergeben. Wenn alle Proben in ihrem natürlichen Zustand sind.
es_3P529IW9K0YPRK5IZRLVRRNEX7ULFC	Wir müssten wissen, wie viel Essig in jedes Glas gegossen wurde, ob die Frazcos die gleiche Menge Essig enthielten und welche Stoffe sich leichter in Wasser auflösen.
es_3P529IW9K0YPRK5IZRLVRRNEZHOFLM	Volumen des für jede Probe verwendeten Essigs. Mindestgröße (Volumen) der verwendeten Behälter.
es_3PB5A5BD0XJWQZCB6HQ3Q75P3ZIG7K	Um das Experiment zu wiederholen, muss man sich vor allem über die Mengen an Material im Klaren sein, die in jedem Experiment benötigt werden: Wie viel Essig sollte jeder Probe zugesetzt werden? Außerdem wäre es für das Experiment besser, wenn in allen Versuchen die gleichen Mengen der einzelnen Proben verwendet würden. Die Temperatur spielt bei chemischen Reaktionen eine wichtige Rolle und bestimmt häufig die Reaktionsgeschwindigkeit und den Abschluss der Reaktion. Daher ist es wichtig zu wissen, bei welcher Temperatur das ursprüngliche Experiment durchgeführt wurde. Es wäre auch wichtig zu wissen, welche Art von Essig zu verwenden ist - er ist im Experiment nicht angegeben, könnte aber einen starken Einfluss auf die Ergebnisse haben, wenn er verändert wird.
es_3PDJHANYK7TRMVTH7D3T5THUPX06HJ	Wie viel Essig wird benötigt, wie viel Wasser wird benötigt, unter welchen Bedingungen sollten die Proben getrocknet werden?
es_3PDJHANYK7TRMVTH7D3T5THURMWH66	Wie viel Essig wurde in jedem Behälter verwendet und wie lange muss jede Probe mit destilliertem Wasser gespült werden? Wie viel wiegt jeder Behälter ohne die Probe?
es_3PH3VY7DJNAB7V8H4HM43UKC7E2ZW7	Um das Experiment zu wiederholen, muss man außerdem wissen, wie viel Essig sie verwendet haben. Insbesondere, wie viele Liter Essig für jedes Material verwendet wurden und ob dies einheitlich war. Eine weitere Information, die für die Wiederholung des Experiments benötigt wird, ist die Angabe der ursprünglichen Masse des Ausgangsmaterials, aus dem die Proben für das Experiment gewonnen wurden. Wir müssen auch wissen, wie die Behälter beschaffen waren, aus welchem Material sie bestanden und wo sie gelagert wurden. Schließlich muss man wissen, ob es für jedes Material eine Kontrolle gab, um sicherzustellen, dass die Ausgangsmasse nicht so sehr von der endgültigen Masse ohne die Verwendung von Essig abweicht.
es_3PM8NZGV80THI3CGRQZDEKMFIKZQXU	Ich müsste wissen, wie viel Essig den einzelnen Proben zugesetzt wurde. Es wäre auch nützlich zu wissen, welche Temperatur der Raum hatte, in dem dieses Experiment durchgeführt wurde, und wie lange die einzelnen Proben gespült wurden.
es_3PQ8K71NHZXDZAX6RKAD4CWCH4TAA6	Ich muss wissen, wie groß die einzelnen Proben sind, wie viel Essig den Proben zugesetzt wurde, wie groß die Behälter sind und wie viel Wasser zum Spülen verwendet wurde. Mit diesen Angaben könnte ich das Experiment wiederholen.
es_3PQMUDRV7TJ7BAZ2FWU3288E62AIIS	Art des EssigsMaterial des BehältnissesLagerungsbedingungen des Behältnisses
es_3PS7W85Z81F49NMA5ENU3MBKQ3XT97	Welche Konzentration oder Art von Essig wurde verwendet? Welches Fassungsvermögen haben die Behälter? Wie viel Essig wurde in die Behälter gefüllt? Unter welchen atmosphärischen Bedingungen wurde das Experiment durchgeführt (Temperatur, Luftfeuchtigkeit, Luftdruck)?
es_3PS7W85Z81F49NMA5ENU3MBKWB2T9Y	Ich verstehe die Frage nicht ganz. 1) Könnten wir mehr Informationen darüber erhalten, welche Art von Ausrüstung benötigt wird? 2) Das Holz ist natürlich und verändert seine Masse nicht. (3) Kalkstein hat sich zur Mehrheit gewandelt.
es_3PWWM24LHUBABJ9NH7XK237J4ZX82S	MIT WELCHEM WERKZEUG SIND DIE PROBEN ZU HANDHABEN? WIE VIEL ESSIG SOLLTE ICH PRO BEHÄLTER VERWENDEN? MUSS ICH DIE PROBEN ÜBER NACHT IN DER SONNE ODER BEI RAUMTEMPERATUR ODER AN EINEM BELÜFTETEN ORT TROCKNEN? MIT WELCHER FORMEL KANN ICH DIE MASSE DER PROBE MESSEN?
es_3PWWM24LHUBABJ9NH7XK237JD8882U	Menge des Essigs, Einweichzeit der Proben in Essig, Trocknungszeit.
es_3PZDLQMM0VYCNMZ0YJDP4P32U7V2C3	Nein se
es_3QECW5O0KJEL80KY2OADR66I2LZ5T3	Die Essigmenge, die Menge des destillierten Wassers und die Aufnahmefähigkeit der Flüssigkeiten in den Proben müssen bekannt sein.
es_3QECW5O0KJEL80KY2OADR66I5SCT5L	Sie benötigen die oben genannten Informationen und auch die Anweisungen.
es_3QECW5O0KJEL80KY2OADR66IAC3T5L	Höhenlage, Temperatur während 24 Stunden, Trocknungstemperatur
es_3QFUFYSY90STTCYXTZME5AL3BOZ4F8	Los estudiantes necesitan añadir el nombre de cada muestra, el tamaño de cada materia y la cantidad de vinagre que hay que añadir en cada recipiente. (Die Schüler müssen den Namen jedes Materials, die Größe jedes Materials und die Menge des Essigs, die in den Behälter gegeben werden soll, angeben).
es_3QILPRALQ78605YG3QV4URAHO1D8NV	Anfangsmasse, Endmasse und die Differenz zwischen den Massen
es_3QIYRE09Y5UOP5EV45MPFHN96KLN1E	Zusätzliche Informationen wären, wie viel Essig verwendet wurde, wie lange die Proben abgespült wurden und ob die Proben vollständig mit Essig bedeckt waren oder nicht.
es_3QRYMNZ7F0UPYPQ46O6ZLN643LSTNE	Nein se
es_3QUO65DNQW1MGN5578WM58SB6HAOUV	Endergebnis, Bild mit der Demonstration und den Daten
es_3QUO65DNQW1MGN5578WM58SBBZ2UOY	Präzisionswaage, Taschenrechner, Pinzette, Pinzette
es_3QUO65DNQW1MGN5578WM58SBD0OUOO	Zunächst muss das genaue Verfahren mit dem gleichen Material und der gleichen Menge Essig wiederholt werden, um die erzielten Ergebnisse zu überprüfen.  Nach der Wiederholung können Sie die beiden Ergebnisse vergleichen und den durchschnittlichen Unterschied zwischen den Massen ermitteln.
es_3QXNC7EIPK83TEPJ7CZKJB9FR7F099	Wie viel Essig muss in jeden Behälter gegeben werden? Mit welchem Instrument wurde die Masse gemessen? Welche Temperatur hatten die verschiedenen Materialien?
es_3QXNC7EIPK83TEPJ7CZKJB9FR9T09R	Ich denke, ich würde die Zeit brauchen, in der das Experiment durchgeführt wird. Je nachdem, ob das Experiment bei Tag oder bei Nacht durchgeführt wird, können sich die Ergebnisse ändern. Außerdem benötige ich die Temperatur des Raums, in dem das Verfahren durchgeführt wurde. Ich müsste den Typ jedes Materials kennen, denn jedes Material hat unterschiedliche Versionen. Zum Beispiel sind der Plastikbecher und der Plastikbehälter beide aus Plastik, haben aber unterschiedliche Strukturen.
es_3R9WASFE21T9W9MMESC4Z6YCCDJFZ0	Menge des Essigs, die in jeden Behälter gegeben wird. Art des zu verwendenden Essigs. Temperatur, bei der das Experiment durchgeführt werden soll. Erstellen Sie zunächst eine Liste der Materialien, die für das Experiment verwendet werden sollen.
es_3RANCT1ZVHU2XTGW33R0ZOSCZSWBU3	Temperatur des Wassers und der Umgebung, ob die Behälter geschlossen waren oder nicht, die Art des verwendeten Essigs und sein pH-Wert.
es_3RRCEFRB7OP3GVMHOX0IMKUIWLZ4B8	Aus welchem Material bestehen die Behälter? Wo lassen wir die Probe trocknen? Was brauchen wir, um die Masse zu bestimmen?
es_3RRCEFRB7OP3GVMHOX0IMKUIXNZB4K	Menge des zu verwendenden Essigs, Menge des zu verwendenden destillierten Wassers, werden Geräte zum Trocknen der Proben verwendet?
es_3S06PH7KSTHF3TNIFB8MJCBFNUQ1D4	Essighöhe (wenn das Material vollständig bedeckt sein muss), Temperatur, Essigsorte, und für mich muss das Ausgangsgewicht gleich sein.
es_3S06PH7KSTHF3TNIFB8MJCBFSLF1DG	Welche Art von Essig muss verwendet werden? Und wie viel destilliertes Wasser kann verwendet werden. Wo und bei welcher Temperatur die Proben 24 Stunden lang gelagert werden. Und wo man die Proben 30 Minuten lang stehen und trocknen lässt.
es_3S96KQ6I9OHGCDZRHUSWPIUAJVSDT4	1) Zeit muss notwendig sein. 2) Formelraum 3) Durchschnittsmasse.
es_3S96KQ6I9OHGCDZRHUSWPIUAKEETD9	1. welche Art von Essig würde verwendet werden, Essigsäure oder eine andere Verbindung? 2. Wie viel Essig soll für jede Probe verwendet werden? 3. Art der Endreinigung, nur destilliertes Wasser? zusätzliches Waschgerät?
es_3SB4CE2TJX8PVN5Z2U2ROK7ABHKAX5	"Bei der Reaktion verbindet sich das Paraffin in der Kerze mit Sauerstoff zu Kohlendioxid und Wasser (und etwas anderem wie elementarem Kohlenstoff oder ""Kohle"", das wir vergessen können). Damit die Reaktion richtig funktioniert, muss das Paraffin im gleichen Verhältnis wie das Methan Kohlenstoff und Wasserstoff beisteuern (siehe Abbildung). Die klassische Erklärung betrachtet die linke Seite dieser Reaktion und besagt, dass der Sauerstoff im Laufe der Reaktion verschwindet, bis er verbraucht ist und nur noch Stickstoff übrig ist (4/5 der ursprünglichen Menge, aufgrund der Zusammensetzung der Luft)."
es_3SB5N7Y3O5HI8OCRLI5UBSV2XHY0GK	Einige Daten könnten sein: Temperatur, Menge des Essigs (ml) und Zustand oder Art der Probe.
es_3SITXWYCNXMUEXAR882NJVRGPLDBXD	Daraus wird geschlossen, dass: Die Kalksteinmasse neigt eher dazu, ihre Masse zu verändern, wenn sie mit Essig in Berührung kommt, während die Holzmasse stabiler ist und keine Veränderung erfährt, wenn sie mit Essig in Berührung kommt. Ich glaube, dass dieses Experiment vollständiger wäre, wenn neben Essig eine andere Flüssigkeit wie Milch oder Öl verwendet würde. Mit freundlichen Grüßen.
es_3SLE99ER0PQJJSA69QQ8GG7R450BZA	ICH MÖCHTE MEHR INFORMATIONEN ÜBER DIESEN PALAST UND SEINE VERWENDUNGEN UND SEINE SEHR SCHLECHTE UNSERER WELT UND SEINE REALISIERUNG VON UNSERER CHEMISCHEN METHODE UND MEHR VON KALKSTEIN.
es_3SNLUL3WO60EA228UGGUDROH830LUL	das Experiment ist sehr gut ausgearbeitet und es bräuchte keine zusätzlichen Informationen, um es zu beantworten, eine weitere zusätzliche Information scheint mir, dass es auf der Ebene der Informationen wäre, zum Beispiel drei wären:1. Dimensionen jedes Materials (sie sollten gleich sein).2. ph jedes Materials.3.
es_3SUWZRL0M0QF2L2FHCVNKQKH5U16EU	die Essigmenge für jeden Behälterwiederholen Sie einen weiteren Test, um die Ergebnisse zu bestätigendie Trocknungszeit sollte länger sein, da einige Materialien wie Holz länger zum Trocknen brauchen können.
es_3TE3O85732LGTOOJGG3KTK2OY9NR2T	Da die Atome in einem Molekül unsichtbar sind, muss es eine ganze Zahl geben, und sie müssen wissen, wie groß die Masse der Probe in Gramm ist.
es_3TEM0PF1Q7AFW420JS4M57S5S6K0DI	1- Geben Sie das Material der Proben an. n2- Das Maß, wie viel Essig zu gießen ist. n3- Wie genau die Proben aus dem Essig zu entfernen sind.
es_3TK8OJTYM3Y4E266RYJ6QUZKTKHPVL	Um das Experiment zu wiederholen, müssen Sie Folgendes wissen:1. Größe und Material des verwendeten Behälters. Geben Sie die Essigmenge an, die in jedes Behältnis gegeben werden soll, und ob sie die Probe vollständig bedeckt.3. Beschreiben Sie den Trocknungsprozess und die Temperatur, bei der die Proben getrocknet werden.
es_3TR2532VIR7ND1O7VD6EH6X92U2J69	mehr Zeit?
es_3TVSS0C0E3DFLJZIYPXMH6JVOKDWTR	Erstens würde ich zunächst eine Kontrollprobe ohne Essig mit einbeziehen, um zu sehen, ob die Probe auch ohne den Kontakt mit Essig an Masse verliert, zweitens könnte die mehrmalige Durchführung der Experimente den genauen Masseverlust nicht immer beeinflussen und drittens die verwendete Essigmenge. Verwenden Sie auch kein destilliertes Wasser, da dieses die Proben beeinträchtigen kann.
es_3TXMY6UCAG1TF51L0U3Q0715E1EQCQ	Marmor, Kalkstein und Kunststoff.
es_3U0SRXB7CFICIADC2Z14L85M6UBRNU	Sie müssen wissen, ob die Materialien nur anorganisch oder auch organisch sein können Sie müssen die Temperatur- und Feuchtigkeitsbedingungen während der Trocknungszeit kennen.
es_3U5JL4WY5MMATYPITTS0BHLAGO94X4	Menge des Essigs (ml), Menge des destillierten Wassers (ml), Art des Behälters
es_3U5JL4WY5MMATYPITTS0BHLAOHBX4T	Welche Art von Container wird verwendet? Welche Art von Essig wird verwendet? Wo werden die Proben aufbewahrt, drinnen, draußen, heiß, kalt?
es_3U5NZHP4LTFZW1BMM922BT8BNY5HPA	1. die Art des Essigs 2. Menge des Essigs 3. Verfahren zur Spülung mit destilliertem Wasser (Zeit, Menge, Anzahl der Wiederholungen usw.).
es_3U8YCDAGXRT9LD65OEA656Z4A02Q0Z	Welche Wirkung hat der Essig auf die einzelnen Proben?n Warum hat Essig eine solche Wirkung auf Stein?n Warum hat Holz keine Wirkung, wenn es in Essig getränkt wird?
es_3UJ1CZ6IZJ2KT07JDO5NH1AWAJG5SH	Macht die Art des verwendeten Essigs einen Unterschied? nWelche Menge Essig wird in jeder Probe verwendet? nMüssen die Behälter aus Glas sein? nMüssen sie abgedeckt oder offen sein, wenn die Proben ruhen?
es_3UJ1CZ6IZJ2KT07JDO5NH1AWBA0S57	1. wie sieht die Probe physisch aus?n2. Die Proben dürfen nach 24 Stunden nicht mehr gewaschen werden. 3. Nach 24 Stunden sofort wiegen.  W = m/V
es_3UNH76FOCUIFXT4Y4TEYGP9J6TYMYF	Anfangsvolumen des Essigs. Endvolumen des Essigs. Spülzeit in destilliertem Wasser oder Volumen des zum Spülen verwendeten destillierten Wassers.
es_3UNH76FOCUIFXT4Y4TEYGP9J84BYMS	Ich brauche dieselben vier verschiedenen Proben und muss wissen, wie viel Essig ich in jeden Behälter geben muss.
es_3URFVVM167VYFRJC9H73L6ZFV69ZUF	"Fügen Sie die folgenden Informationen hinzu, um die Anleitung und die Informationen zu verbessern:nn- Lassen Sie die Proben während des gesamten Experiments im selben Raum und vermeiden Sie gekühlte oder sonnenbeschienene Orte, um größere Temperaturschwankungen und Störungen der Ergebnisse zu vermeiden.nn- Erstellen Sie eine Tabelle mit den Spalten ""Probenname"", ""Anfangsmasse (g)"", ""Endmasse (g)"", ""Differenz zwischen den Massen (g)"" und füllen Sie die Zeilen mit den gesammelten Informationen aus."
es_3UXUOQ9OKGAVG8Z8KHYTULUM52A7A0	Ich müsste wissen, wie viel Essig in jeden Behälter gegossen wurde, welche Art von Essig es war und wie schnell die Masse jedes Behälters abnimmt.
es_3VD82FOHKS1QUTO5LHBMB265VVWOC2	Zeit, Essiggehalt, Material
es_3VELCLL3GMWC1D1E6H3C7CE06FA1F6	Art des Behälters, ob die Proben zur gleichen Zeit getestet wurden und die Form der Proben
es_3VFJCI1K41C68IWQFVO9VOWPCBORGE	- Wie hoch wäre das Ausgangsgewicht - Die Menge des Essigs - Die Art des Behältermaterials, in dem die Proben bleiben sollen
es_3VHP9MDGRPXWOGBCMESWO8XR5WRCFW	Für jedes Verfahren kann die benötigte Zeit beobachtet werden, und das Ergebnis jedes Experiments besteht aus unterschiedlichen Ergebnissen, mit oder ohne mehr Konsistenz.
es_3VNXK88KKEVJMFQZA9N944Z5WX2V95	Um das Experiment besser zu erklären, müssen wir zunächst die Masse des Essigs (Zusatzdaten 1) und nach dem Experiment (Zusatzdaten 2) wiegen. Es ist zu überprüfen, ob sich die Masse, die die verschiedenen Proben verloren haben, in dem Essig aufgelöst hat (erfasste Essigmasse, zusätzliche Daten 3).
es_3VSOLARPKDMZA6OGQZH3L97MUII39O	Es ist nicht klar, was der Zweck des Experiments ist. Wenn ich es richtig verstanden habe, versuchen Sie, die Wirkung von saurem Regen auf verschiedene Materialien mit Essig zu simulieren. Die Proben werden zunächst gewogen, dann in Essig getaucht, um die Erosion zu simulieren, und schließlich messen wir die Massen, um zu sehen, wie viel Material verloren gegangen ist. Um das Experiment zu reproduzieren, müssten wir wohl etwas mehr über die Essigbehälter wissen. Die Größe der Behälter und die (zumindest ungefähre) Menge des zu verwendenden Essigs oder der Anteil der zu verwendenden Probe müssten angegeben werden. Die Art des zu verwendenden Essigs sollte bekannt sein, d. h. seine Dichte sollte genau angegeben werden. Auch die Dichte der Materialien ist nützlich. Dies ist wichtig, denn wenn die Dichte des Essigs geringer ist als die der Proben, sinken die Proben auf den Boden des Gefäßes. Die Tiefe des Gefäßes wiederum beeinflusst den Druck auf die Proben, wenn diese sinken. Es ist auch wichtig, die Anfangstemperatur des Essigbades zu kennen. Wenn keine Angaben gemacht werden, wird davon ausgegangen, dass es sich um Raumtemperatur oder Standardtemperatur, d. h. 25 °C, handelt. Vielleicht wäre es wichtig, den relativen Masseverlust jeder Probe zu berechnen, d. h. das Verhältnis ihrer Endmasse zu ihrer Anfangsmasse. Zumal die Proben nicht alle die gleiche Ausgangsmasse haben.
es_3W92K5RLWWU0LSON7JASSOU366G5VR	Wie viel Essig man einfüllen muss, wie groß die Behälter sind, wie man die Masse bestimmt
es_3WJ1OXY92CTZGM4RUMQZ8LQHJY7A88	Zusätzliche Daten: a. Temperatur in den Behältern während der 24 Stunden. Spezifische Art der einzelnen Materialien. Beispiel, Art des Kunststoffs, Holz usw.\nc. Menge des verwendeten Essigs.
es_3WOKGM4L73T601TP91I2G144P2P0O6	Um ein zuverlässigeres Ergebnis zu erhalten, ist es notwendig, mindestens 3 Tests zu wiederholen.
es_3WR9XG3T65OGEJJRBGO2HI8MK0W74U	1. welche Art von Behälter verwendet wurde. 2. welche Art von Essig verwendet wurde. 3. die Gesamtzahl der verwendeten Proben.
es_3WR9XG3T65OGEJJRBGO2HI8MLXF748	Lassen Sie einen mit nichts, um die Abstände zu sehen. nSample: GlassSample: Metal
es_3WS1NTTKE0PCUOGWAYZCT7VQ1350FZ	Menge des in jedem Experiment verwendeten Essigs.
es_3WS1NTTKE0PCUOGWAYZCT7VQ2AN0FW	BÜGELN, ALUMINIUM, FASER
es_3WSELTNVR5FIE6WFXK1UZHM42Y3TA6	Ich denke, die Informationen, die aufgenommen werden könnten, um das Experiment genauer zu machen, sind das anfängliche Volumen des Behälters, in den der Essig mit jedem Material gegeben wird, das endgültige Volumen nach der verwendeten Zeit und die Gesamtdifferenz. Auch die Veränderung des pH-Werts (Säuregehalt) des Essigs/der Materialien vor und nach dem Experiment. Bestimmen Sie schließlich, ob das Experiment auf Meereshöhe (als Kostenfaktor, der sich auf das Experiment auswirkt) oder in größerer Höhe durchgeführt wurde, was sich auf den Wert der Schwerkraft und damit auf den Gewichtswert (gr) auswirkt.
es_3WYP994K194D8QJ6HD7HRTCXMBOY6S	Die Verdunstungskühlung unterscheidet sich von typischen Klimaanlagen, die mit Dampfkompressions- oder Absorptionskältekreisläufen arbeiten. Das Funktionsprinzip der Verdunstungskühlung beruht auf der Ausnutzung der großen Verdampfungsenthalpie des Wassers in Abhängigkeit von der Oberfläche, auf der es aufliegt.
es_3WYP994K194D8QJ6HD7HRTCXNH76YW	Holz, 0,0; Kalkstein, -1,3; Marmor, -0,4.
es_3WZ36BJEV5TNXG173Y1QUS6ACHPTBW	Es ist wichtig zu wissen, ob es sich bei den Proben nur um anorganische Materialien handelt oder ob sie auch organisch sein können. Der Rest der Anweisungen ist klar und es ist einfach, das Experiment zu wiederholen.
es_3X08E93BHXVBP690BUCP82S4EPN66V	Die Größe der Behälter, die Menge des Essigs in den Behältern und ob die Behälter verschlossen waren oder nicht.
es_3X0H8UUIT31E6JM39PSW71N9L8QSW2	Ich muss wissen, welche Fehlergrenzen bei der Messung von Massen verwendet werden. Ich muss die genaue chemische Zusammensetzung der verschiedenen Proben kennen. Ich muss wissen, ob menschliches Versagen im Spiel war.
es_3X4MXAO0BI1254MQU0SRHRID2UTRWE	Die Essigmenge in jeder Probe, die Anfangsmasse der Proben, die Endmasse der Proben
es_3XC1O3LBOUZZAPNJUBQK8V2FSBMLTY	Zunächst würde ich gerne wissen, wie die Hypothese des Experiments lautet. Zweitens müsste ich wissen, wie viel Essig ich in jeden Behälter geben muss. Drittens müsste ich wissen, wie lange ich jede Probe mit destilliertem Wasser abspülen muss.
es_3XCC1ODXDNOXL7Q4IRTLP20RFKSQR8	1. eine Beschreibung der Ziele und/oder Hypothesen des Experiments. 2. Eine Liste der benötigten Materialien mit Mustern. 3. Eine Beschreibung der Umgebung, in der das Experiment durchgeführt werden soll, sei es in einem offenen Gelände oder in einem Labor. Die zu treffenden Vorsichtsmaßnahmen.
es_3XM0HYN6NMCNCRKKW8UWQQBYVCREPT	Herkunft und Eigenschaften der Proben: welche Art von Holz, welche Art von Kunststoff, welche Art von Essig (Säuregehalt), ob die Behälter abgedeckt werden sollen oder nicht.
es_3XUHV3NRVMBV3RT32UTODN3UR8CH5B	Ich bräuchte die Menge des verwendeten Essigs. Außerdem müsste ich die Temperatur der Behälter während der 24 Stunden kennen. Schließlich benötigen Sie die Volumina der Proben vor und nach dem Experiment.
es_3YGXWBAF72UMQ0EN2XWDX400F3R4C2	Um das Experiment zu wiederholen, müsste ich wissen, wie viel Essig ich verwenden muss, sollte er die Probe vollständig bedecken? Außerdem wird nicht angegeben, welche Form die Proben haben und ob sich dies auf die Kontaktfläche mit dem Essig auswirkt; ist jede Probe ein einzelner Materialblock oder sind es mehrere Stücke? Und schließlich, welche Art von Essig sollte verwendet werden, ist es nicht klar, um mir, dass jeder Essig wird die gleiche Wirkung.
es_3YHH42UU5DSYUGQSW92AOK0A1ZKL0L	den Säuregehalt des Essigs zu bestimmen und festzustellen, wie er das Material angreifen kann ndie Reinheit und Härte der Materialien zu prüfen ndie Temperatur zu messen, bei der die Tests durchgeführt werden
es_3YHH42UU5DSYUGQSW92AOK0AR0AL03	ART DES MATERIALS MENGE DES VERWENDETEN ESSIGS TROCKNUNGSMETHODE
es_3YJ6NA41JDTVN76CA95NN6OQWHVPJN	Ich bräuchte die Ergebnisse des ersten Experiments, ein Messgerät, um das genaue Gewicht jeder Probe zu messen, und ich bräuchte Fotos von den Ergebnissen des ersten Experiments.
es_3YMTUJH0DUT3CHGYOJR3ME04C8LT4F	Welche Art von Essig war es? Wie viel Essig wurde verwendet? Abmessungen des Behälters? Müssen die Proben vollständig bedeckt sein? Umgebungstemperatur? Welche Art von Kunststoff? Welche Art von Holz? Welche Art von Kalkstein? Welche Art von Marmor?
es_3YZ8UPK3VVZL7Y82H3NVA8YUEE3UCZ	Die atmosphärischen Bedingungen, die Menge des Essigs im Vergleich zum Gewicht des Materials und die Genauigkeit der Messmittel kennen.
es_3YZ8UPK3VVZL7Y82H3NVA8YUM6MUCA	Bei den Proben wurde festgestellt, dass es eine Stabilität ohne jegliche Veränderung gab, da sich die Masse des Holzes nicht änderte. Bei den anderen Proben gab es jedoch eine Veränderung der Masse.
es_3Z3ZLGNNSK75255271SP74XB64X3QV	Anfangs- und Endmenge des Essigs in jedem Behälter. Größe des Behälters. Ist das Material vollständig bedeckt?
es_3Z3ZLGNNSK75255271SP74XBDIX3QU	madera
es_3Z3ZLGNNSK75255271SP74XBDNU3Q1	Wie viel Essig? Bis die Probe eingetaucht ist? Das Flüssigkeitsvolumen des Essigs sollte gewogen werden.
es_3Z4AIRP3C8QT1ZSZ6B9YDJE75MQ1XG	- Wie viel Essig in die Behälter gefüllt werden soll- Welche Art von Essig es ist (Apfelessig, Preiselbeeressig...)- Die Größe der Behälter
es_3Z4GS9HPNXNDX61ADEM9KUSW5YF77T	Ich bräuchte die Art des verwendeten Holzes, z. B. Kiefer, Eiche oder andere. \Das Gleiche gilt für die Art der Plastiktüte oder andere Arten von Kunststoffen. \Ich bräuchte auch die Temperatur, bei der die einzelnen Experimente durchgeführt wurden, oder ob es irgendeine Art von Heizung gab.
es_3Z4XG4ZF4A4BCZCK5WIDST1FHAQX8O	Holz ist die beste Masse, gefolgt von Marmor, gefolgt von Kalkstein.
es_3Z4XG4ZF4A4BCZCK5WIDST1FKJ6X8P	Das müsste ich wissen: Die chemischen Eigenschaften des Essigs, das Material der Behältnisse und ob sie während der 24-stündigen Wartezeit versiegelt waren, sowie die spezifische Zusammensetzung jeder Probe (welche Art von Holz? welche Art von Kunststoff? usw.).
es_3Z7VU45IP0UI6USE7TXJA4UIE7IZ1C	1. ich müsste wissen, ob die Massen fest oder pulverförmig sind. 2. Ich benötige die Temperatur des Raums, in dem die Proben waren, abzüglich der 24 Stunden und wann sie getrocknet wurden. 3. Welcher Filter wurde zum Ausspülen verwendet? Um zu sehen, ob es möglich ist, dass beim Abspülen Stoffe austreten. Mit wie viel destilliertem Wasser wurden sie abgespült? Ein Liter? 50 Liter?
es_3Z9WI9EOZ11YLAE69HXUFCMCWMSHK1	Ich benötige die Maße der vier Behälter, wie viel Essig verwendet wurde und auf welcher Art von Oberfläche die Proben getrocknet wurden.
es_3ZPBJO59KREQ748WH0B7BZRM9LPDHR	1. wir müssen wissen, wie viel Essig Sie verwendet haben. 2.  Wir müssen wissen, wie groß die Oberfläche der Proben ist. 3.  Wir müssen wissen, ob der Essig die Probe vollständig bedeckt.
es_3ZPPDN2SLX92K44DFJYZ40BJL7TE9B	Lassen Sie die Proben für den endgültigen Teig stehen und trocknen.
es_3ZPPDN2SLX92K44DFJYZ40BJLFTE9R	die Zeit, die Menge des verwendeten Essigs und die Menge des verwendeten Teigs.
es_3ZPPDN2SLX92K44DFJYZ40BJLII9EH	zu wissen, wie viel Essig zu verwenden ist und wo er zu lagern ist, bei welcher Temperatur usw.
es_3ZQIG0FLQGTUYB373KX1IO7GT24VWJ	1. wie viel destilliertes Wasser wurde für das Experiment verwendet?n2. Welche Art von Essig wurde für das Experiment verwendet?n3. Welche Menge Essig wurde für das Experiment verwendet?n4. Welches Behältnis haben Sie für die Proben verwendet?n5. Wo wurden die Proben zum Trocknen aufbewahrt? In der Sonne? In einem Klassenzimmer? n6. Wurden alle Proben zur gleichen Zeit getrocknet? Je nach Probenmaterial können sie langsamer oder schneller getrocknet sein.
es_3ZR9AIQJUDM2W8J7QH3T23YZ9KT04J	Die Schüler könnten die gleichen Verfahren wie das Experiment mit drei verschiedenen Materialien durchführen: Watte, Eisen und Backpulver.
es_3ZSANO2JCHKCVX08J0IW3D19X9NFST	Um das Experiment zu wiederholen, muss man das Wasser und den Essig gleichzeitig einfüllen, weil man nicht weiß, ob der Unterschied im Wasser oder im Essig liegt. Außerdem wäre es sinnvoll, verschiedene Massen zu verwenden, weil man dann weiß, was die Masse und was die Probe ist. Außerdem sollte man zu Beginn Proben verwenden, die das gleiche Gewicht haben.
es_3ZSY5X72NZOU0VDO3E1H0X5R44XORV	Nach meinem besten Wissen und Gewissen glaube ich, dass die folgenden Daten erforderlich sind.nn1. Menge des für jede Probe verwendeten Essigs.n2. Volumen der verwendeten Behälter.n3. Volumen des verwendeten destillierten Wassers.n4. Temperatur, bei der diese Proben 24 Stunden lang aufbewahrt wurden.n5. Es ist auch wichtig zu erwähnen, ob die Proben 30 Minuten lang bei Raumtemperatur oder an einem trockenen Ort ohne Luftzufuhr trocken gehalten wurden.
es_3ZY8KE4ISLGPEE7LRBYVQZPU3PJVQL	Bestimmen Sie die Masse der einzelnen Proben
es_3ZY8KE4ISLGPEE7LRBYVQZPUV6VQVI	Art des verwendeten Essigs (pH-Wert des Essigs) Art des verwendeten Holzes und Kunststoffs (es gibt verschiedene Arten von Holz und Kunststoff) Geometrie der Probe (hatten alle Proben die gleiche Geometrie, Prisma, Kugel usw.)
