id	text
es_3018Q3ZVOK35YRJNTVWZZ2LMBENRA7	blanco :: EL experimento demuestra que mientras más claro el color, la temperatura dentro del recipiente es más baja, por lo tanto para ofrecer una temperatura más tolerable al perro en las horas del dia, el color blanco va a favorecer una temperatura fresca en el interior de la caseta.
es_3018Q3ZVOK35YRJNTVWZZ2LMDXXAR4	blanco :: el blanco puede dejar la caseta una temparatura mas baja, como no aumenta la temperatura tanto como los otro colores
es_304SM51WA5HMIGOSEYW0KNAOI0CSBJ	blanco :: Se va a ver la casa grande
es_308Q0PEVBAQE096ZB2OQPF9BKSU9I0	gris claro :: De acuerdo con esta tabla, las cuatro tablas diferentes negro, gris oscuro, gris claro blanco Mi elección es griss claro porque es perfecta para la pintura de la casa.
es_308XBLVESKHAH1OFZ9WVUD5SV4ABR6	blanco :: El color blanco se hace la temperatura mas bajo dentro del interior de la caseta.  El experimento soporta este conclusion porque la temperatura dentor del bote fue mas bajo con blanco comparado a los otro colores (negro, gris, etc.).  Entonces, cuando hace calor, el color blanco sea el mejor color para una caseta para mi pero porque se reflecta mas luz cuando hace calor.
es_30H4UDGLT4VLOFCXD6IF3YG74D7PMG	blanco :: Mientras el color usado para la caseta del perro sea mas oscuro, la caseta será mas caliente debido a que los colores oscuros absorben mayor energía. Como se observa en los resultados del experimento, a medida que el color sea mas claro, la temperatura dentro será menor. Entonces como el color mas claro es el blanco, entonces es el preferible debido a que resultará de una temperatura lo mas agradable posible para el perro.
es_30IQTZXKAMJTUA7HAS5YZEVX1AY0XN	blanco :: Basado en los resultados, la caseta debe ser blanco porque va a mantener la caseta mas fresco y que el perro no sobrecalienta.
es_30LB5CDZNENIZ57WBATJWZB87AM0Z8	negro :: Escojo el negro por que aumentara la temperatura del aire dentro de un bote y asi veremos como afecta los colores
es_30X31N5D653HZ6J08KW4PCQISR8ASX	blanco :: el blanco absorbe menos luz por tanto se elevará menos la temperatura dentro de la caseta
es_30ZX6P7VFA8ZV0568BUBRTGXKAC2JR	blanco :: El color blanco puede ayudar a que el interior de la casete la temperatura sea mas baja, esto es bueno en climas calidos. Como se puede observar la temperatura media con la tapa de color blanco es la menor de todas las tapas de colores mas oscuros
es_30ZX6P7VFA8ZV0568BUBRTGXKD0J22	gris claro :: Le otorgaría mas luminosidad a la caseta y mantendría un ambiente mas fresco en el interior de las misma
es_317HQ483I95ZPBATCC7V7G4VP67INI	negro :: El color negro  prodria afectar al interior de la caseta porque los colores oscuros absorben mas energia. En las pruebas el color negro tuvo los resulatados mas grandes porque absorbe mas energia. La media de el color negro es 53.
es_3180JW2OT6PRUXOTQUW9P0J965QJ54	blanco :: Una caseta de color blanco debería hacer que la temperatura del interior de la caseta no se vea tan afectada por el exterior. Es decir, si hace mucho calor afuera, el perro podrá sentirse mas a gusto en el interior de la caseta. Si hace frío, al no haber una fuente de calor en el exterior, da lo mismo si fuera de color negro, ya que de todas formas no tendría mayor temperatura.
es_3180JW2OT6PRUXOTQUW9P0J98C25JI	blanco :: La fórmula general es que el color oscuro absorbe el calor, por lo que, de acuerdo con este fenómeno, el color negro aumentará el calor.
es_31EUONYN2XGMT2U5CY6R1UUUG7WOVV	gris claro :: Para dar una respuesta más precisa, sería necesario conocer el material de la caseta, pero a priori, en función del mismo teorema contenido en el ejercicio, esto es, considerando que los colores oscuros absorven más energía, y no sabemos si la caseta está en una zona de extremo calor o extremo frío, lo mejor es optar por una respuesta neutra, que otorgue la mayor calidez posible en invierno y el menor calor posible en el verano.
es_31JLPPHS2W72HTSMSO0LIZ2BT8DO3I	blanco :: El color blanco afectaria el interior de la caseta porque los colores mas claros no absorben tanta energia como los mas oscuros como el negro.
es_31JLPPHS2W72HTSMSO0LIZ2BURA3OX	blanco :: El color blanco no absorbe tanto calor como los otros colores, y seria mejor que la caseta no se caliente tanto para que el perro no sufra los calores del verano.
es_31LM9EDVON5VKMUZUUSVJHJV26QJNV	blanco :: Escoji el color blanco para que estuviera agradable la temperatura tanto en el invierno como en el verano.
es_31LVTDXBL9NMUAARQMLP8G1X1WARLL	negro :: Usa efectos psicológicos de color negro para crear un aspecto elegante y audaz para tu hogar. Si lo usa de manera inteligente, el negro le da un aire elegante y sofisticado al diseño de interiores. Si se pone en un color de fondo claro o neutro, todo lo que es negro se destacará. El color negro es ideal para resaltar ciertas cosas en una habitación. La mayoría de las personas asocian el negro con la muerte, el luto, la viudez y, en general, con ocasiones formales y serias. En conclusión, no use demasiado negro, sino solo para resaltar ciertas cosas como marcos de cuadros, mesas pequeñas, etc.
es_31LVTDXBL9NMUAARQMLP8G1X2TCRLI	negro :: ESTE EXPERIMENTO CAUSADO A CONCLUIR EL INTERIOR FUE DEMASIADO TAMBIÉN POR ESTA LÁMPARA Y SU TEMPERATURO SUPERIOR. SE AFECTÓ EL BRILLO DEL INTERIOR.
es_31Q0U3WYDRSZMKM8OY50JK1J80W71V	gris oscuro :: De acuerdo con esta tabla, las cuatro tablas diferentes negro, gris oscuro, gris claro blanco Mi elección es griss claro porque es perfecta para la pintura de la casa.
es_31QNSG6A5T6HXK6TNJEFYUORGDU87G	blanco :: El color blanco refleja mas luz, entonces la temperatura no aumentara demasiado cuando el perro esta en la caseta durante tiempo caliente.
es_31UV0MXWNSPVZM4N8CB9DZ49WBL5I7	blanco :: Es el color que menos calentaría el interior del caseto ya que el experimento confirma la hipótesis inicial de que cuanto más oscuro sea el color más energía absorbe. Con el caseto de color blanco el perro tendría un refugio más fresco en los días de mucho sol.
es_326O153BMKBENUHURZ31QWU9F01ED4	gris oscuro :: El gris oscuro puede ayudar a usar menos energia sin important la hora del dia que la caseta este expuesta al sol. Aire acondicionados o calentones necesitan mucha corriente electrica para mantener un espacio a una temperatura estable durante el dia y la noche. Si todos las pruebas empezaron con una temperatura de 24C and consequentemente temperaturas fueron registradas despues de differentes tiempos, el color gris no fue afectado sin importar el tiempo que la tapa estuvo expuesta a la luz creando calor. Esto puede ser comparable con la luz solar en un edificio y las horas que el edificio esta expuesto al sol.
es_32EYX73OY2MPD0XLZ0DQZ3XGEKEURN	blanco :: Ccon la incidencia de calor la temperatura no se eleva tanto como los otros colores.
es_32KTQ2V7RFS0WSWQWHMIH8GS19NM9I	blanco :: El color blanco haría que la caseta aumentara de temperatura lo menos posible, con una media de 42º
es_32KTQ2V7RFS0WSWQWHMIH8GSU9M9MX	negro :: Porque a su perro le gustaría estar caliente, negro es el mejor color para la caseta. Los resultados del experimento demostran que negro absorbe mas energia, porque la temperatura de la tapa negra aumentó más.
es_32M8BPYGAVZTFJT7P8U0HWVYIFDIG2	blanco :: El blanco mantendría la temperatura de la casa mucho más fresca durante todo el año. Como se muestra en el gráfico anterior, es la temperatura más fresca en todas las escalas. El blanco tiene un albedo alto, lo que significa que mantendrá las temperaturas frescas.
es_32RIADZISUH2XH3JZJMDC94I07D4SX	blanco :: El color blanco reduce el calentamiento por el sol del interior de la caseta y el perro estará más cómodo.
es_32RIADZISUH2XH3JZJMDC94I08B4SX	blanco :: Al pintar la caseta de color blanco, no habría un incremento tan alto de la temperatura dentro de la caseta si ésta es expuesta a la acción de la luz solar o luz artificial intensa.
es_32SCWG5HIJHJZCR5QQBYE2JL9DO6PE	blanco :: El color blanco refleja menos calor a dentro por lo tanto se debe pintar la caseta con el color blanco para disminuir la temperatura dentro de la caseta.
es_32SVAV9L3HMDFPYLI5V3H4I671K3AW	negro :: El color negro hará que la temperatura del aire dentro del bote sea más alta, el experimento prueba que su hipótesis era la correcta dado que la temperatura si era más alta por lo que si absorbe más energía.
es_32UTUBMZ7I92A85W8T15VAUVA57BV3	gris claro :: El color gris claro aria que la temperatura dentro de la caseta suberia, pero no tanto. Los resultados del experimento dicen que si el color es negro la temperatura sube mas de doble la temperatura inicial, pero el gris claro es un oco menos de lo doble.
es_32ZKVD547H0IYZ3DOJVZCF2CL9U3BS	blanco :: La caseta seguira menos caliente por el color blanco. No absorbera tanto el sol.
es_32ZKVD547H0IYZ3DOJVZCF2CNTK3BO	blanco :: Al utilizar el color blanco la temperatura dentro de la caseta se mantendra mas fresca y sera mas agradable para el perro
es_336YQZE83XRHV5UETR915SBQC7QM5Y	blanco :: Basado en los resultados entre mas claro menos energia absorba. El color blanco la temperatura esta mas baja q el color negro
es_337RC3OW07FENHR8Z6QZ9DQ0M1BVL4	blanco :: De acuerdo al experimento los colores de los objetos afectan la temperatura de los espacios a los cuales contienen, demostrando que los colores claros como el blanco retardan el calentamiento del aire contenido en un objeto, a diferencia de los colores oscuros como el negro que acelera el calentamiento del aire que se encuentra contenido en un objeto
es_338JKRMM28CS9X5KXQK5LYJGR9LAH0	blanco :: Segun el experimento, el color blanco fue el que mantuvo la temperatura del aire mas baja, comparado con los otros colores, gris, gris oscuro o negro. Por lo que si se quiere mantener una temperatura fresca en la caseta, optaria por el color blanco.
es_33CID571066UB8PPFWKTQIYHUEG3L6	blanco :: El color blanco afectará a la caseta reflectando la luz solar y por lo tanto manteniendo el interior a una temperatura fresca, sin posible riesgo de sobre calentar el aire y asfixiar al animal. Como se ve en la tabla, el color blanco presenta los resultados de temperatura más bajos mientras que, conforme se aumenta la oscuridad del color, la temperatura aumenta también, llegando hasta los 54ºC.
es_33CKWXB73LXLBY76ZIORIAA6YV711U	blanco :: Los materiales de color blanco reflejarán más energía de la luz y el calor que los de un color más oscuro. Por lo tanto, una construcción hecha de materiales más ligeros tendrá una temperatura interior más baja que una construcción hecha de materiales oscuros. Esto se demuestra claramente en el experimento, ya que el bote con la tapa blanca alcanzó una temperatura promedio de solo 42 ° C en los tres experimentos repetidos. El bote con el top negro, sin embargo, alcanzó 53 C en tres experimentos. Los botes con tapas de color gris claro y gris oscuro fueron de temperaturas intermedias como se esperaba.
es_33F859I568QXS7AC34K1G93M3X8BH4	blanco :: Se encuentra demostrado mediante el experimento realizado que los objetos pintados de color blanco es el que menos incrementa su temperatura al interior de los mismos, pues solo se incrementó en 18 °C durante la exposición y considerando que será una casa para un perro, el cual le es más difícil regular su temperatura, es más conveniente que no aumente demasiado.
es_33FOTY3KEOY5Y1H4FFDBZ6TX3JA1CF	blanco :: Con la tapa de color blanco la temperatura del aire dentro del bote obtuvo los valores mas bajos en todas las pruebas. Por lo tanto se asume que en una caseta obtendria resultados similares.
es_33ISQZVXPRZPL4R2VC2VG2CO716CCR	gris claro :: DEPENDIENDO DEL CLIMA ES BUENO SABER CUAL ES LA MEJOR TEMPERATURA PARA EL CACHORRO , TAMBIÉN LA DISTANCIA DE LA LAMPARA TAMBIÉN ES UN FACTOR DETERMINANTE , YO PONDRÍA UN COLOR NEUTRO DONDE LA TEMPERATURA NO TENGA TANTA VARIACIÓN !!!
es_33ISQZVXPRZPL4R2VC2VG2CO728CCV	blanco :: La energía luminosa puede ser absorbida o reflejada. Las superficies y objetos oscuros absorben la luz y la convierten en energía térmica, haciendo que la temperatura de ese objeto se sienta más cálida. El objetivo de nuestra caseta es prevenir la mayor transferencia de calor posible para mantener a nuestro cachorro fresco. Al mantener el calor, estamos haciendo el interior más fresco. La caseta blanca refleja más luz que los colores más oscuros. La caseta blanca debe ser la más fría por dentro. La caseta negra absorbe la mayor cantidad de luz, y esta energía se transfiere dentro de la cabina con el tiempo y calienta el interior.
es_33IZTU6J83ETVJRTJUOI9K1G1MUXST	blanco :: El color blanco mantiene la temperatura del aire dentro la caseta muy fresquita
es_33IZTU6J83ETVJRTJUOI9K1GXNVSXN	blanco :: el blanco absorbe el calor y por esta motivacion es el major color para la pintura de la caseta . Como se puede veer las temperaturas de el aire con el color blanco son las mejores .
es_33LKR6A5KGXMKIJF1181OGT1VA71T9	blanco :: el color blanco es el ideal porque demasiado calor para el perro nunca es bueno
es_33PPUNGG3AI6ZZRV5NCYGVCVMHIZR6	blanco :: Basado en la información proporcionada en la tabla, el color blanco es el que absorbe menos calor y mantiene la temperatura por debajo de los 45 grados centígrados de acuerdo a los resultados. Blanco es la mejor opción para Brandi y Jerry.
es_33TIN5LC06N0Q9L4FKATB33ZAK99Y5	blanco :: El color blanco haría el interior de la caseta mas fresco que los otros colores. Según a los datos, el color blanco disminuye la temperatura interna mas que los otros colores.
es_33UKMF931BXNT2VO3KSBUMCWQO2TT7	blanco :: color blanco porque absorbe menos la energia del calor, por tanto la temperatura sera menor dentro de la caseta
es_34BBWHLWHCOPC5J74DYI3ZHMF5OWI7	blanco :: En un lugar cálido, con mucho sol, un color claro o blanco haría que la temperatura dentro de la caseta fuera lo más baja posible, con una diferencia de hasta 12º respecto de un color negro.  Según la ubicación de la caseta, también nos podría interesar pintarla de un color oscuro, para aumentar esta temperatura.
es_34FNN24DCOMHPMJSCUXCZNYXHNO5YZ	negro :: De acuerdo con las pruebas que se hicieron, es evidente que el color negro aumentó significativamente más la temperatura que los otros colores. Esto es debido a que mientras más oscuro es el color, mayor absorción de energía tiene el objeto de dicho color.
es_34FNN24DCOMHPMJSCUXCZNYXHZGY58	blanco :: El color blanco no absorbe tanta energía, por lo tanto la caseta no encerraría tanto calor. Es una buena opción, si Jerry y Brandi viven donde hay un clima muy caluroso.\nSi es para clima frío, el color negro sería mas eficiente e ideal.
es_34FNN24DCOMHPMJSCUXCZNYXLCB5Y4	blanco :: El color blanco hara que la casita para el perro se quede mas frio en el verano.
es_34HJIJKLP79IP9KNTERINWOPZAPV49	blanco :: El color blanco repele mas energía que los colores oscuros por tanto usar un techo de color blanco parece la mejor medida para mantener la caseta del perro con una temperatura mas baja.
es_34HJIJKLP79IP9KNTERINWOPZILV4L	blanco :: El color blanco mantendría la casa más fresca, no absorbe tanto la energía como el color blanco.(White would be best for the dog house, it would keep the house fresher since white does not absorb as much energy as black)
es_34MAJL3QP60YD0I494LC41W681F34P	gris claro :: con este color se puede presentar una temperatura promedio de unos 45 grados segun la tabla de expermientos provista. Quizas una temperatura adecuada para un perro y considerando que la luz en la prueba hace la función del del sol...
es_34PGFRQONQOL7G3DMVJIF0WMPE7WJY	blanco :: el color blanco logra que la temperatura dentro de la caseta sea mas bajo
es_34Q075JO1ZQL49MO3ZKR45RWT4110T	blanco :: Debido a que los colores oscuros absorben mas energía y calientan mas el aire dentro de la caseta, al elegir pintarla de color blanco se obtendría una caseta mas fresca.
es_34QN5IT0T143F9692KT6JFE477Y805	blanco :: El color blanco es el unico que mantuvo una temperature de 43 oh menos, el color blanco es el que menos absorbe el calor del sol. Conviene mas a tener la casa blanca para que nocoserva tanto calor durante el verano.
es_34QN5IT0T143F9692KT6JFE4CUG08U	blanco :: Según los resultados del experimento. La Tapa Blanca es la que aísla o refleja el calor emitido por la lampara. Asi que una caseta para la mascota deberia tener un techo de ese color, si lo que se busca es que el perro este c'omodo. Sin embargo habría que definir si la caseta se usar'a en climas templados o de invierno.
es_34S9DKFK752LFBPYGUTYT4YJEU6YNE	blanco :: Los colores obscuros absorben mas energia, de acuerdo a los resultados de este estudio. El color blanco absorbe menos energia y como resultado es menos caliente y el interior de la caseta del perrito seria mas fresco y menos caliente.
es_34T446B1C2R5RCWMJW9BL1AN5TW0CE	blanco :: Porque si llegal a hacer la pintura en el color negro se va quedar muy caliente adentro. La color blanca es mejor porque la temperatura se va mantener mas baja.
es_34V1S5K3GUEY7PBY91F1SCJ64DX96L	gris claro :: eligiria gris claro ya que en verano no tendria tanto calor y en invierno no seria lo ideal pero al menos no es tan frio como podria serlo con el blanco, cuanto mas negro sea el color elegido mayor calor va a tener la caseta
es_34V1S5K3GUEY7PBY91F1SCJ683896G	blanco :: Tal y como se esperaba con este experimento, los datos recogidos demuestran que los colores oscuros absorben más energía que los colores claros. El color blanco es el que menos radiaciones absorbe. La caseta blanca será la que menos aumente de temperatura expuesta al sol.
es_34X6J5FLPVBGNJ7RAMKCNBE03JPQJ1	blanco :: El color blanco o los colores claros en general hacen que en la caseta haya menos temperatura y ya que estamos construyendo una caseta para un perro, lo ideal es que sea de un color claro, para que el animal tenga la temperatura más agradable posible.\nSi usáramos un color oscuro la temperatura aumentaría a más del doble, de la temperatura exterior, tal y como queda reflejado en el experimento con la lampara.
es_351SEKWQS2UCZI978XRK34ZILU7MDX	blanco :: El color blanco mantendra la temperatura de la caseta a una temperatura mas baja que cualquier otro de los de mas colores en las tres pruebas el color blanco fue siempre el que logro una temperatura mas baja.
es_352YTHGROXQD78P3OPAE8VXGV0S4HK	negro :: Negro
es_352YTHGROXQD78P3OPAE8VXGYDI4H3	blanco :: Este color asegurera que la temperatura al interior de la caseta no esta tan alta, especialmente en el verano
es_354P56DE9MGZG4L21HKKFLOSR8H7SW	blanco :: basado en el experimento, diría que el color blanco es el adecuado puesto que, no absorbe mucha energía.
es_354P56DE9MGZG4L21HKKFLOSSBAS7H	blanco :: Blanco
es_358010RM5G69NB8XDPTNK7LNS8OXVQ	blanco :: La temperatura en el interior de la caseta deberia ser mas baja que con cualquiera de los otros colores
es_358010RM5G69NB8XDPTNK7LNU96XVC	blanco :: El mejor color para la caseta es el color blanco, ya que es que hace que la temperatura de la caseta sea menor. Debido a que el perro es un ser vivo, nos interesa que este a una temperatura confortable.
es_35GMH2SV3GU5RR8JH8HH1Q68MYXOE7	negro :: Pienso que el color está más lleno de medios, son más verdes que los demás.
es_35H6S234SCDF629M6B2KGWE4IGZ65A	blanco :: El color blanco va a mantener la temperatura en la caseta mas bajita que un color oscuro.
es_35H6S234SCDF629M6B2KGWE4KN356T	blanco :: las temperaturas que se obtuvieron al usar el color blanco son las mas bajas, pero van desde 41 a 43 grados centigrados, es una temperatura muy elevada para que un perro pueda estar en una caseta.
es_35K3O9HUADQBLEVQI5YREWXUOC5FEZ	blanco :: En el experimento, la tapa blanca era la que daba lugar a una temperatura inferior dentro del bote. Por tanto, si la caseta se pinta de color blanco, su temperatura interior no incrementará tanto como con uno de los otros colores.
es_35K3O9HUADQBLEVQI5YREWXUP47FEM	blanco :: Al usar color blanco la temperatura dentro  de la caseta se mantendra mas fresca que si utilizan colores oscuros.
es_35L9RVQFCQVCO6JI3V1WLZVAWKVHUF	blanco :: Sin duda el mejor color es el blanco porque absorberá menos calor que los colores más oscuros. El blanco podría ser positivo para usarlo porque en verano, cuando normalmente hay altas temperaturas, la caseta no aumentará excesivamente su temperatura. Esto es porque la luz que incide sobre las superficies claras se refleja, mientras que la que incide sobre los colores oscuros es absorbida. Esto explica porque en nuestro experimento, cuanto más oscuro el color, mayor temperatura dentro del recipiente.
es_35L9RVQFCQVCO6JI3V1WLZVAXOPUHV	blanco :: CONSIDER TO BANOS
es_35L9RVQFCQVCO6JI3V1WLZVAY8YHUW	blanco :: Usar una tapa del color blanco asegurará de que no hace tanto calor dentro de la caseta. En el experimento, el bote de cristal con tapa de blanco solo llegó a 42 grados, mientras el bote de cristal con tapa de negro llegó a 53, entonces seria mejor para el perro si uso la tapa del color blanco. Seria mas fresco.
es_36AHBNMV1TPCTZYLR0FVXZMPX0PDYD	blanco :: El mejor color para la caseta de su perro é el Blanco, pues tinen las menores temperaturas, con media de 42ºC.
es_36H9ULYP647JWUHIW69IBCAMTDUJF3	gris oscuro :: El mejor color seria el gris oscuro porque aunque la temperatura sube mas que con el color blanco , con el gris se mantiene constante , lo cual servira tambien para los meses de invierno al no enfriarse tan rapido.
es_36H9ULYP647JWUHIW69IBCAMTEDFJK	blanco :: Se probó el hipótesis del experimento: los colores más oscuros absorben más calor, y así resulta que el interior del bote se calentó más con la tapa negra que con la tapa gris oscuro, y éste se calentó más que el bote con la tapa gris claro, etc. Si yo diseñara una caseta para un perro, querría darle un color más claro para que el interior calentara lo menos posible.
es_36NEMU28XHQB8O9YPSWAVSO3SL7MWM	blanco :: ya que los colores oscuros absorben mas energía al colocar el color blanco estamos permitiendo que haya una temperatura mas baja en el interior de la caseta
es_36PW28KO419GPNEI7PCZ0VM3Y8NEAB	gris claro :: Gris Claro porque despues de las tres pruebas y la ultima con media sale como el mas mejor
es_36TFCYNS46N45ADD80CJ56UEKQQHXR	blanco :: La temperatura de la caseta sería menor ya que el blanco atrae menos energía
es_36V4Q8R5ZMD6ORDCDJX4336H4CPMQ1	blanco :: Este color prodria absorber menos energia y la tempertura no estaria tan caliente por lo tanto es mas esencial para que el perro se adapte a su nuevo hogar. Si estuviera oscura, la caseta absorveria mas energia y la caseta se calentaria mas rapido y el pobre perro se prodria enfermar con lo caliente que se puede poder llegar.
es_36V4Q8R5ZMD6ORDCDJX4336H4HQQMG	blanco :: Pintar la casa de color blanco ayuda a que la mayoría de la radiación del sol se refleje al exterior, y eso hace que el material de la casa se caliente menos y pase menos calor al interior de la casa, lo que la hace más fresca y reduce la posibilidad de que el perro quiera salirse de su casa y quiera entrarse a la casa de sus dueños. En el experimento la tapa de color blanco permitió que el interior del bote se calentara lo menos posible, lo que indica que la pintura blanca dejaría calentar la casa menos que los otros colores.
es_36V4Q8R5ZMD6ORDCDJX4336HB55QME	blanco :: el color reflejará la luz mejor
es_36W0OB37HYRTA5DS9I042RAPVW9ZH6	blanco :: BLANCO IS PERFEACT FOR BEST ONE
es_36ZN444YTTBH7WA5DR78M540B2TIOI	negro :: el color negro mantuvo la temperatura mas elevada.
es_373ERPL3YQLADNIWZVNGU7BEZYRRT1	blanco :: Según los experimentos, el color blanco es más eficiente que otros colores, lo que ayuda a mantener el interior de la casa para mantenerse fresco.\nCada resultado del experimento muestra que absorbe menos calor que otros.\nPor lo tanto, he elegido el color blanco, debido a las lecturas del experimento.
es_374TNBHA8D86I82QWMLFXYTOJW4QYM	blanco :: No se trata de aumentar la temperatura, se trata de la absorción de luces y la reflexión. El color que tiene una longitud de onda alta absorbe más luz y se convierte en calor, mientras que los colores de baja longitud de onda reflejan las luces
es_379J5II41QTXL65M4G1P992EQEWLEW	blanco :: Cuanto menos oscuro es el color de la caseta, menos aumenta la temperatura del aire dentro de la caseta.  Si brilla el sol y hace calor afuera, el interior de una caseta de color blanco mantiene una temperatura mas bajo que una caseta de color gris o negro.  Por supuesto, si hablamos de una clima fria, probablemente es mejor elegir el color negro para aumentar la temperatura del interior de la caseta.
es_37C0GNLMHHGAAFOFLHK3E82WVUND69	negro :: El color negro afectaria de una manera positiva porque la temperatura del aire seria la mas alta con el color negro.
es_37Q970SNZGLL5I60C13BEBXFQASS19	blanco :: El color blanco sera mejor para su perro porque aumentara menos la temperatura que el color negro o los otros. Como dice el hipotesis, lo mas oscoro el color, absorbe mas energia y lo hace mas caloroso.
es_37Q970SNZGLL5I60C13BEBXFSGW1S0	negro :: es asi como paso.
es_37TD41K0AJM5SLGYSYSVV7G6ZRPCSY	blanco :: El color blanco fue el que menos alza de temperatura generó, por lo tanto es el más indicado para pintar la caseta, de este modo el perro no se verá sometido a una temperatura excesivamente alta.
es_37W3JXSD68LB25YC8VKLPNBA8R9WY9	blanco :: Al no ser un color oscuro ayudará a que dentro de la caseta no haya tanto calor. Sin embargo, hay que tener en cuenta las características del perro, qué tan peludo es.
es_37WLF8U1WR3IOLUPDY6QILXMF3X6KS	blanco :: seria mas fresco, estaria menos caliente. saludos.
es_37ZHEEHM6YZVWN0NB2JJ7DGG2KG37L	blanco :: De acuerdo a los resultados el color blanco es el que mejor resiste el calor externo y por ende debería ser el que se utilice para el techo de la casa.
es_384PI804XUELYTLIGIZB06E5MVS0SB	gris claro :: El gris claro seria el mejor ya que los dos más oscuros harían que con la cantidad de luz que hay en verano la cantidad de calor que hubiese dentro de la caseta fuese muy grande, en cambio, en invierno, cuando menos luz hay la blanca se quedaría corta para dar la cantidad de luz suficiente como para calentar bien la caseta
es_386PBUZZXHA5WMREIHCG6PF6QDSLJU	gris claro :: Hay un experimento casero clásico que consiste en poner una vela en un plato con ... Hay tres fenómenos que ocurren en el interior del vaso mientras arde la vela: ... Por tanto el agua sube para rellenar ese hueco, de 1/5 del volumen original. ... Como se puede ver en el experimento, la presión no varía ...
es_38F5OAUN5PPAQV7MQN8LB7HQQQCH7R	blanco :: se ve mas claro
es_38SKSKU7R3A91B780ZRGUO06FXVLIA	negro :: Puede dejar el ambiente más oscuro en un determinado punto de vista
es_38YMOXR4MWC9JLO62CPT6WRH6AW6WI	negro :: En efecto el color negro atrae más las partículas de luz (fotones) lo que hace que al aumentar su atracción térmica esta aumente de manera más rápida así como su gradiente térmico que también será mayor.
es_38YMOXR4MWC9JLO62CPT6WRH76YW63	blanco :: El color blanco ayuda mantener la temperatura da caseta más baja. Para comprobar esto, es suficiente ver la tabla con las temperaturas medias.
es_392CY0QWG34D330NU7SZ87YVRD6I4M	gris claro :: gris claro 46
es_39ASUFLU6ZKSL0MBIZ4DK3X1SA6XEZ	blanco :: El blanco no absorbe el calor, por lo tanto, ayudará a mantener la habitación más fresca.
es_39JEC7537WELKDX2MTX06U0DRVXCVA	gris oscuro :: el gris oscuro esta mas estable
es_39JEC7537WELKDX2MTX06U0DW6PVCC	blanco :: Me gusta mucho el blanco. Es un color muy puro y bello para el alma y los ojos.
es_39KFRKBFIP83XWPAH9TB8TYO2Q3YOR	blanco :: Con una caseta pintada de blanco, el perro estará sometido a temperaturas menos extremas en días de intenso sol.
es_39LNWE0K4W9CK1U29DJHLBWPXTVUIZ	blanco :: El color blanco seria el ideal para la caseta del perro ya que el mismo experimenta el menor aumento de temperatura según el experimento.
es_39LOEL67OUIZW156L7BPLDCBBFA38G	gris claro :: es muy obvia se puede afectar de manera drastica ademas es todo comun mi opinies es clara y cientifica es te es mi beredicto es cierto esta luz y su conponentes
es_39LOEL67OUIZW156L7BPLDCBEE583H	blanco :: EL COLOR DE BALNCO ES MUY EFECTIVO PORQUE ES MINGLE EN PRUEBA 42,43 ES UNA COMBINACIÓN MUY ATRACTIVA Y PRUBA 3 DE 41 TAMBIÉN ESTÁ BRILLANDO DEL RESULTO, Y SU PERFECTO COLOR DEL PERRO Y MIDA DEL 42 ES MUY ACABADO DEL PERRO
es_39O5D9O87V5184VJ2JRUNZ8U1DLC3Z	gris oscuro :: De todos los colores utilizados en el experimento es el que aporta una temperatura media, por lo que será adecuado tanto para condiciones de temperatura externas de calor como de frío.
es_39RP059MEJ6JKLBNU10E8EBIPS8BM1	blanco :: Cuanto mayor sea la temperatura, mayor será el malestar en el medio ambiente.
es_39U1BHVTDN4IULXUO5MKC98YOWU3TB	blanco :: El color blanco no absorbe la luz tanto como los otros colores, si no que mas la reflecta.  Cuando no se absorbe la luz, entonces no se calienta tanto. Por eso es que los experimentos con la pintura blanca tienen las temperaturas mas bajas.
es_39ZSFO5CAA98FCE8RV4HXCBP358JUB	blanco :: Si Brandi y Jerry viven en un clima cálido el color más apropiado es el blanco, puesto que así la temperatura interior de la caseta no subiría tanto durante los días soleados y podría mantenerse algo más fresca. Si pintan la caseta de un color oscuro, la habitabilidad de la caseta en verano puede resultar insoportable. La otra opción es que si Brandi y Jerry viven en un clima más frío y poco soleado entonces sería mejor que pintarán la caseta de negro para que así en invierno los días soleados la caseta pueda mantener una temperatura interior algo más cálida.
es_3A0EX8ZRNA1JE201D4OP29YPUUFYBN	gris claro :: Supón que decido cultivar germen de soya en mi cocina, cerca de la ventana. Siembro unas semillas de soya en una maceta con tierra, los pongo en el alféizar de la ventana y espero a que germinen. Sin embargo, después de varias semanas, no hay germinado. ¿Por qué? Bueno... resulta que olvidé regar las semillas
es_3A4NIXBJ78CVXUXZLEP8MH7NW3DLMI	negro :: La caseta sería más cálida al interior si fuera el color negro. Los resultados del experimento apoyan este conclusión porque se muestra que cuanto mas oscuro el color de la tapa, más aumentará la temperatura del aire al detro el bote de cristal.
es_3A4NIXBJ78CVXUXZLEP8MH7NYWSLML	blanco :: El experimento demuestra que cuanto más claro sea el color menos calor acumula en el interior. Por lo tanto, el mejor color para el tejado de la caseta del perro es el blanco. No obstante, la temperatura mínima alcanzada en el experimento (41ºC) es excesivamente alta para que la soporte un ser vivo durante un espacio prolongado de tiempo.
es_3A4TN5196MVG2C2IH4GWRT94JAAHC1	blanco :: El color más apropiado sería el blanco, por qué es el color que mantiene la temperatura más baja, usar los otros colores del experimento haría de esa casita muy caliente
es_3A9AA95ATYZNG8RRL71TMW5LFGUP5W	blanco :: Gracias al experimento se puede observas que el color blanco es la mejor opción ya que, después de 10 mín expuesto a la lampara éste color absorbe menos calor que los colores oscuros.
es_3AMYWKA6YDZ1ECF4BQYJP2EV072O6O	blanco :: Durante las temporadas de calor y mucho sol el color optimo para usar seria el blanco ya que despues de haber hecho el experimento los resultados nos dicen que ese es el color que menos energia absorvio de la lampara. El perro podra estar comodo durante el verano viviendo dentro de su caseta.
es_3AMYWKA6YDZ1ECF4BQYJP2EV1YEO6J	negro :: El color negro maximiza la temperatura interna y podria ser util en el invierno.
es_3AMYWKA6YDZ1ECF4BQYJP2EV4WX6OJ	blanco :: El color blanco es el color que mejores beneficios traerá a la caseta pues es el que absorbe menos calor al ser el color mas claro, los colores oscuros absorben la luz y eso afecta directamente en la temperatura, mientras que los colores claros, en este caso el blanco reflejan la luz y absorben menos calor.
es_3AQF3RZ55AV78Z2BCNFT285HBTY6FK	gris claro :: Hay un experimento casero clásico que consiste en poner una vela en un plato con un poco de agua y taparla con un vaso. La vela va consumiendo oxígeno hasta que se apaga, y el agua entra en el vaso, dado que allí ha disminuido mucho la presión. Sale siempre, sale muy bien y es muy agradecido… lo que no está tan claro es lo que realmente ocurre, y cual es la razón de esa variación de presión. Javier Fernández Panadero, hace unos días publicaba sobre eso aquí mismo en Naukas (ver) dejando claro que la explicación “clásica” no es la buena.
es_3ATTHHXXWC1415OXEIU45IVTPQRXI1	blanco :: La temperatura cambia dependiendo el color.Si el negro hace que suba la temperatura entonces el blanco hace que baje.
es_3AUQQEL7U761QL2MAD4GBTYCMX3V0P	blanco :: Los resultados dicen que el blanco causa la temperatura más baja. Por eso, el blanco se debe usar.
es_3B1NLC6UG19LW5GB23KKQTWA316GPP	negro :: negro xq estara mas caliente para el perro
es_3B1NLC6UG19LW5GB23KKQTWA40TPGK	blanco :: El color blanco puedia ser que la casa se sienta fresca cuando esta bien caliente afuera y el perro no se va calentar mucho
es_3B837J3LDQ99YN5HAVIQK2FSTOZSRD	gris oscuro :: La temperature dentro del  bote aumentara.
es_3BC8WZX3V59XX854V6ILUSAW8KBRRG	blanco :: Blanco seria el mejor color para la caseta del perro porque no absorba tanto calor y luz como los otros colores usado en el experimento. La caseta no estaría tan caluroso por dentro si la caseta es pintada blanco. En el experimento, la tapa blanca solo tenia un medio de 42 grados C mientras los otros tenían un medio más alto que la tapa blanca.
es_3BDCF01OGZ7VRBMD4HDJGCUU4CFLYT	blanco :: la temperatura aumenta sin importar el color, pero el color blanco aumenta menos grados de temperatura. Eso seria mas comodo para el perro en la caseta en un clima caluroso
es_3BQU611VFRXLP8DW78IDCMA806999Q	blanco :: Al pintarla de color blanco los rayos del sol se reflejan de mayor manera, de este modo la cantidad de calor que absorbe es menor lo cual se evidencia en la tabla previamente mostrada. asi que es mejor pintar blanco para reducir la temperatura dentro de la caseta del perro.
es_3BQU611VFRXLP8DW78IDCMA8Y8K993	gris claro :: si es que es verano la temperatura no va a ser tan alta dentro de la caseta del perro. Si  es que es invierno va a permitir que se caliente un poco mas que si tuviese una caseta blanca. Considero que es neutral el gris claro
es_3BWI6RSP7IMY6LGK0M0FQ4KDS7ZE7B	blanco :: Elegiria el color blanco ya que absorbe menos energia, lo cual ayudaria a que las temperaturas dentro de la caseta paa el perro sean mas frescas.
es_3BXQMRHWK1BYGKKTUSH9D436785UMA	blanco :: Blanco sería el color más indicado pues de todas ellas es la que mantiene la temperatura más fresca, luego el ambiente no se vuelve muy caliente
es_3C5W7UE9CH3QXOEOZXSWXB2A1FKMX6	blanco :: Pinturas con colores blancos bajan la temperatura de la caseta de diez a doce grados; asi que es mejor tener pinturas blancas o de gris claro.
es_3CCZ6YKWR9W2OLBK4I5W0656BM095U	blanco :: Los resultados del experimento prueban que el color blanco retiene menos energia. Por lo tanto el color blanco seria mas adecuado para la caseta
es_3CFJTT4SXV3AMQI6W5Q6BJI5JKK7IU	blanco :: El color blanco sería el mejor para asegurar que el interior de la caseta no se caliente demasiado. Le media temperatura del color blanco fue la más baja en el experimento (42C) y lo mas oscuro que era el color, la mas alta la temperatura.
es_3CFVK00FWNYT8RC7YYIRXLA144G6LB	gris claro :: El gris claro es un color neutro y por lo tanto la temperatura estaria a un nivel promedio.
es_3CFVK00FWNYT8RC7YYIRXLA146UL68	blanco :: El color blanco es el mejor color porque mantiene la temperatura más baja dentro de la caseta del perro.  Si es que la caseta está temporalmente afuera en el sol, entonces el perro tendrá menos posibilidades de sofocarse, ya que la temperatura promedio con el color blanco dentro de la caseta es 42 grados centígrados, la cual es la más baja de todos los colores. Sin embargo, si es que fuera es la temporada de otoño o de invierno, entonces \nes será mejor escojer el color negro, ya que afuera este color calentara mejor la caseta del perro bajo los rayos solares.
es_3CN4LGXD5Z1ZT3FSYPE2UVSJKLX4YO	blanco :: El color blanco no absorbe el calor y no subirá la temperatura de la caseta. En verano el perro podrá estar dentro de la caseta sin tener calor.
es_3CPLWGV3MQC6EAHQ8I1IUN5S0XIN9U	gris oscuro :: el calor que se econcentrat dentro del bote hace que el color que se comienza a diseminar dentro del bote baje la intensidad de color negro a uno mas tenue
es_3D8YOU6S9GXWRHZ17CASO86KHXHU65	blanco :: El color blanco sería el color que haría que la temperatura seria más baja por lo que muestra la media y por lo que el perro estaría en una mejor situación.
es_3DBQWDE4Y8BNDNFE5SO1I70QG6JN5Z	gris claro :: creo que daria un tono mas claro en las casetas
es_3DBQWDE4Y8BNDNFE5SO1I70QLQW5N3	blanco :: Describe Como see color podiatry affect Al interior DE la cassette. USA sol resultants Del experiments para apiary too description.
es_3DI28L7YXCRKVZ1IB6J6PUT0RKTE18	negro :: Debido a que es el color que mas absorbe la temperatura el termómetro indica que la misma dentro de la caseta es mas alta que los otros expuestos
es_3DL65MZB8FS4I2BGR38Q6QCRSS8CE3	gris claro :: Entre más claro sea el color la temperatura dentro de la caseta será menor. Yo elegí el gris claro, pero también podría haber elegido el gris oscuro, ya que cualquiera de estos colores sería útil tanto para climas fríos como climas cálidos. El blanco en un clima frío haría que la caseta sea más fría aunque en un clima cálido haría más agradable la temperatura en su interior, y por el contrario con el color negro la caseta en un clima cálido sería muy caliente, pero en un clima frío podría aportar algo de calor.
es_3DPNQGW4LNSXAJ5MS6JAB48QJFG466	negro :: Podria aumentar la temperatura dentro de la caseta debido a que los colores oscuros tienden a acentuar el calor.
es_3DR23U6WE7RL4JDRDP3GV0CVNAUET9	blanco :: Los colores claros a diferencia de los oscuros tienen mayor dificultad para absorver las ondas de luz, por lo que, tienden a su vez, a tener mayor dificultad para retener dicha energía en forma de calor, por lo que el color ideal para la casa del perro es el blanco, pues este es el mas claro y mas conveniente por lo anterior mencionado
es_3DUZQ9U6SO11RUMYJFN0LZ4VDRCVS2	blanco :: El color blanco hará que la temperatura de la caseta del perro no aumente tanto como en el caso de usar pintura de un color mas oscuro. Blanco sería ideal para evitar que el perro se sofoque y pueda estar a gusto dentro de la caseta.
es_3DUZQ9U6SO11RUMYJFN0LZ4VDUNSVG	blanco :: El color blanco seria el mas indicado para pintar la caseta, ya que es el color que más ayuda a que no se caliente demasiado la temperatura en su interior. S
es_3DY4FPOOA31PQFML4QNVVPZZRRARVV	negro :: En todas las pruebas el color Negro subio mas en temperatura acomparado a los otros colores.
es_3DYGAII7PNLC9UAP5ZPWK70C9OZQPE	blanco :: De acuerdo con el experimento el color blanco seria el color mas adecuado para la caseta, ya que mantendría una buena temperatura.
es_3DYGAII7PNLC9UAP5ZPWK70CA03PQ6	gris claro :: Si no sabemos las condiciones climáticas, no sabemos si queremos aportar una mayor o menor temperatura a la caseta. Deberíamos tener una caseta para perro de color blanco en verano y una de color negro en invierno. Suponiendo que solamente pudiesemos construir una y en un clima frio en invierno y cálido en verano. Mi opción sería gris medio, aunque aquí he seleccionado gris claro por falta de otra opción. El gris claro calentaría un poco la caseta, pero no demasiado.
es_3DYGAII7PNLC9UAP5ZPWK70CG6UQPG	gris claro :: De acuerdo con esta tabla, las cuatro tablas diferentes negro, gris oscuro, gris claro blanco Mi elección es griss claro porque es perfecta para la pintura de la casa.
es_3E13VNJ1NP8WB4347P9XA9RSFQ9I1G	blanco :: Utilizando una tapa blanca seria mejor que los otros tres colores porque la blanca aumenta la temperatura solamente a la media de 42 grados de celsius.  Los otros colores aumentan la temperatura del aire dentro del bote mas arriba y seria peligroso a su perro.
es_3E13VNJ1NP8WB4347P9XA9RSIU31I4	blanco :: La lámpara produce calor infrarojo que es parecido al calor de los rayos del sol.\nSuperficies de colores claros reflejan el calor infrarojo en comparación con superficies oscuras que lo absorban.\nUna caja oscura se calentaría mucho por el día, así que una caja de un color claro seríá mucho más cómoda porque la temperatura sería más constante.\nLo opuesto sería cierto por la noche porque una caja de color claro reflejaría el calor infrarojo al perro y mantendría al perro más caliente por la noche.
es_3E13VNJ1NP8WB4347P9XA9RSJKTI1S	blanco :: Este color para la pintura de la caseta para perro genera el menor calentamiento posible interno de la caseta frente a una fuente de calor externo (ejemplo practico: sol).
es_3E1QT0TDFRMEM4NP6AICPJE0TWG8IR	blanco :: Al ser el color mas claro y tras ver los resultados del experimento, es fácil concluir que es el color adecuado para la caseta, ya que mantendrá el aire en su interior mas fresco que las demás opciones.
es_3E1QT0TDFRMEM4NP6AICPJE0YUF8IR	blanco :: Blanco
es_3E337GFOLBLLTK4YMO7SM4RF4Z8GNN	blanco :: Color seleccionado: blanco\nSe puede concluir en base a los resultados arrojados por el experimento realizado que los colores si se pueden afectar con la temperatura.\nRecomendación: \n-depende de que temperatura desea que tenga la mascota debe escoger el color.\n-se seleccionó el color blanco debido a que mostró la temperatura más baja y puede  dar confort al perro en tiempos de calor.\n-dependiendo de la temperatura que desea en el escala de más frió a más caliente se presentan las siguiente opciones:\nopción 1: blanco\nopción 2: gris claro\nopción 3: gris oscuro\nopción 4: negro
es_3E337GFOLBLLTK4YMO7SM4RFBWPNGC	blanco :: como ese color los resultados del experimento 43 blanco gris claro 44 45
es_3E4GGUZ1TA4U6KBOQWUNS8GA03BK2G	blanco :: La caseta para el perro sera más fresca adentro cuando el sol está brillante y la temperatura es caliente afuera. La pintura del calor blanca se reflejará la energía del sol. Bíen hecho Brandi y Jerry!
es_3E4GGUZ1TA4U6KBOQWUNS8GA1LBK2H	gris claro :: Debído a que es un color intermedio, tanto en verano como en invierno daría mejores resultados reteniendo el calor en los días fríos y manteniendo una temperatura aceptable en los días más calurosos.
es_3E4GGUZ1TA4U6KBOQWUNS8GA28OK25	blanco :: El color blanco es el que mayor energia repele y por tanto menos calor absorve. SI colocamos un techo de color blanco el calor se transmitira en menor medida al interior de la caseta permaneciendo  con una temperatura inferior.
es_3E7TUJ2EGEZXSYQDJONFYITYMS1D9L	blanco :: El color blanco es el recomendado pues absorbe menos temperatura y la caseta se mantiene con mas baja temperatura que otro color
es_3EG49X351WPO8LTWCHLF8F5ODRWX6O	"blanco :: Una hipótesis no necesariamente es correcta. Más bien es la ""mejor suposición"" y los científicos deben ponerla a prueba para ver si realmente es correcta. Los científicos comprueban las hipótesis haciendo predicciones: si la hipótesis text \n es correcta, entonces text YYY debería ser cierta. Luego, realizan experimentos u observaciones para ver si las predicciones son correctas. Si lo son, la hipótesis tiene sustento. Si no, es el momento de plantear nuevas hipótesis."
es_3EJJQNKU9TIK8ER1Z16RGO8QRWBRHT	blanco :: color podria afectar la interior de la caseta
es_3F0BG9B9MR0WCQXB0NC9X7CT9WEY79	blanco :: El blanco es el color que menos absore energia debido a su composicion, ya que esta formando por todos los colores.\nPara la caseta del perro de Brandi y Jerry el color ideal es el banco debido a que tuvo menor temperatura y la variacion entre prueba fue de 1-2 grados entonces con ese resultado podemos objetar que el blanco posee menor temperatura y la variacion de la temperatura media es minima.
es_3F6KKYWMNDEIH0U7KY6KGJOITMYNDM	blanco :: El color Blanco, ayudaria a el perro dentro de la caseta que se mantenga en un sitio de temperatura controlada y mas cercana a la temperatura fuera de la caseta.
es_3FE7TXL1LK0GHN9J31EKOUSJY8Z2QJ	blanco :: Según los resultados del experimento, el mejor color para la caseta del perro, es el blanco. es el que menos temperatura absorbe, por lo que seria el ideal para el perro de Brandi y Jerry
es_3FFJ6VRIL31W4FIMB65XW48IAXV0IL	gris claro :: El color gris claro ayudaria para que la temperatura subiera un poco y el perrito no sienta tanto frio. Usar un color mas oscuro seria perjudicial porque el perrito podria sentir mucho calor y querria estar fuera de la casa.
es_3FQ5JJ512N1QV60HCFS7KWJ8ATLNKI	blanco :: La temperatura de el aire con ell color blanco fue las mas baja con 42 C. La caseta tiene que ser blanca para que el  perro no sufra de temperaturas altas. Mientras mas oscura la pintura, peor seria para el perro.
es_3FQ5JJ512N1QV60HCFS7KWJ8AVMNKN	blanco :: Eligiria el color blanco porque la temperatura incrementa a un paso menor que el de los colores oscuros. Esto es importante pensando que el perro tambien necesita temperaturas mas bajas con todo el pelo que tienen. Basado en el experimento, el blanco demuestra tener una temperatura mas baja.
es_3FTF2T8WLTVW14Q40JS5Q6IJSETW9A	blanco :: blanco despera mas que los otros.
es_3FTF2T8WLTVW14Q40JS5Q6IJUDA9W4	blanco :: Como el color blanco es el color que menos absorbe energia el interior de la caseta no se calentara tanto como usando otros colores.
es_3FTF2T8WLTVW14Q40JS5Q6IJXRLW9X	blanco :: El color blanco, al reflejar los rayos del sol, hará que la temperatura de la caseta sea menor que con una pintura de cualquier otro color. Los resultados del experimento apoyan esto ya que indican que las temperaturas dentro del bote de cristal con menores al usar la tapa blanca.
es_3FTYUGLFSWYERBO1GYAYM2OW01L5DZ	negro :: De acuerdo de los resultados del experimento, una caseta negra será más caliente que una caseta blanca porque los colores más oscuros absorben más energía y aumentaran la temperatura dentro de la caseta.
es_3G0WWMR1UXXC69YCPKC4GIVHB7RQN9	gris claro :: El color gris claro seria le mejor opcion, segun la tabla de resultados se encuentra en el medio de los extremos lo que haria que las variaciones de temperaturas externas debido a los cambios de estacion no sean tan extremas.
es_3GDTJDAPVWO0INDGRPG4HCLHALQM87	gris claro :: Blanco
es_3GDTJDAPVWO0INDGRPG4HCLHI4R8M4	gris oscuro :: GEIS OSCURO
es_3H0W84IWBMF8O40Z90YLVLBDRWXREF	gris oscuro :: Un dato importante para este experimento es el clima de la zona donde está instalada la caseta, creo que podría elegir el gris oscuro porque la temperatura es más estable y el color negro por ejemplo si en verano hace mucho calor sería demasiado incómodo para descansar.
es_3H7XDTSHKE4BGEDCEPYFIN461XDGWR	blanco :: El color si tiene efecto en la temperatura que la caseta tendra  en su interior. Por los datos dados el color que menos energia consume es el blanco comparado al color negro.
es_3H7Z272LX9K1IXUCDUH03L1I31ILPW	gris claro :: Considero que es un punto intermedio ya que hay otros factores que no se están teniendo en cuenta otros factores como la localización de la caseta (exterior o no), si suele ser un clima húmedo o caluroso, etc...
es_3H7Z272LX9K1IXUCDUH03L1IZ8IPLA	blanco :: El blanco es el color que menos subiría la temperatura en el interior de la caseta los días de calor (18 °C sobre temperatura inicial, frente a los casi 30 °C que sube la temperatura cuando se usa el color negro). En invierno cualquier otro de los colores usados en experimento contribuiría a templar más la temperatura en el interior de la caseta, pero dadas las características de los perros y su pelaje, es más conveniente priorizar que en verano no suba demasiado la temperatura.
es_3HFNH7HEMJR6WHHQ2GZ9QYMKCO7QGR	negro :: el color negro es el mejor para afectar el interior de la caseta porque el color negro es el que atrae mejor el calor del aire. Por eso el perro podrìa estar mejor. Los datos lo demuestran porque la caseta negra consigue tener una temperatura de 54 grados, màs o menos.
es_3HHRAGRYXAIOWVH29X1V9C5XSIG9OC	blanco :: De acuerdo a los resultados el color blanco es el que menos absorbe el calor de los rayos del sol, por lo tanto la temperatura dentro de la caseta del perro no sera tan alta como si se pintara con otros colores
es_3HMIGG0U4NJ0C42UAS4FB78OKHJ8Y7	blanco :: Si lo que se quiere es una caseta con una temperatura menor (especialmente para verano), el color tendría que ser el blanco, porque no absorbe el calor como lo harían colores mas oscuros
es_3HMVI3QICL5I14I9B7V0WXLGCN51Y2	gris oscuro :: Gris oscuro es el color medio que mejor reaccionaría como una opción real y buena para hacer la casa, la temperatura estaría en buenas condiciones, la caseta tendrá una buena apariencia y representará un hogar realmente maravilloso para vivir.
es_3HOSI13XH119VO3UV4SHKECOH91DDJ	blanco :: DE ACUERDO A ESTA MESA BRANDI Y JERRY ELIGE EL CUATRO COLOR DE ELECCIÓN, UNO ES NEGRO, GRIS OSCURO, GRIS CLARO, BALNCO. PIENSO QUE EL COLOR BLANCO PERFECTO BECUASE ES PRUBA 1 Y PRUEBA2 ES MINGLE DE 42 Y 43 Y PRUEBA 3 Y MEDIA ES 41 Y 42 ASÍ QUE TODA COMBINACIÓN ES MUY BUENA Y BLANCO ES PERFECTO PARA EL PERRO.
es_3HPZF4IVNO62O7S7R4KKDT47B3PCYT	negro :: Según los resultados del experimento, el negro es el color que aumentaria mas la temperatura de la caseta. Esto se debe a que el negro absorbe la luz en lugar de reflejarla, por lo que recibe más energía de esta. Este color sería ideal para utilizar en casetas destinadas a zonas frías.
es_3HPZF4IVNO62O7S7R4KKDT47C7AYC9	gris claro :: la temperatura en el gris oscuro no cambio en absoluto
es_3HRMW88U183I0Y8DWL3POXFZUY30MC	blanco :: El blanco es el color con la temperatura mas baja en todas las pruebas. Para una caseta de perro seria el mejor color para que al perro no le de calor.
es_3HVVDCPGTG5JAOUIDQFA234BXTCYTR	negro :: El color negro dará un hogar más cálido para el perro
es_3HYA4D452TWJQYJAPL3QCVO5R3T2FM	gris claro :: Gris claro
es_3HYA4D452TWJQYJAPL3QCVO5R4EF2M	blanco :: El mejor color es blanco porque así se mantiene más fresco el aire adentro de la caseta. Se nota por los resultados del experimento que la tapa blanca mantenía la temperatura del bote más bajo que las demás tapas.
es_3I2PTA7R3V7BY3D9S7KOOQEDFBUKQ2	gris claro :: Podría impactar el interior al hacer que se vea más vibrante, moderno y atractivo.
es_3I33IC7ZWHFOU722E5HYYUDEZK3A23	blanco :: EL INTERIOR DE LA CASETA VA A SER MAS FRESCO. COMO SE PUEDEN VER EN LOS RESULTADOS, LA TEMPERATURA DEL AIRE DENTRO DEL BOTE DE CRISTAL CON LA TAPA BLANCA FUE DE 42, 43, 41 Y 42. EN LAS CUANTRO PRUEBAS ESE FUE EL RESULTADO MAS BAJO. ESO ES BUENO. Y SIGNIFICA QUE EL COLOR BLANCO ES EL MAS FRESCO.
es_3I3WADAZ9SH5V8FQ67OEXW0V8YN5OX	blanco :: por que la pitura blanca calienta menos y la temperatura es menor
es_3IGI0VL649X9LXLWA7K0RD0HUZ1NOA	negro :: La luz no es más que radiación electromagnética y como tal, transporta energía. Los colores claros, como el blanco, son los que más reflejan la radiación, y por lo tanto absorben muy poco o irradian la energía que absorben muy rápidamente. Los colores oscuros, como el negro o el gris oscuro, son los que más absorben la radiación. Son capaces de absorber mucha energía de este tipo, y luego van irradiándola lentamente. De esta forma, si utilizamos colores oscuros para la caseta de nuestro perro, los mismos absorberán la radiación solar durante el día, y proporcionarán calor a nuestro perro por más tiempo a lo largo de la noche. Cuanto más oscura sea la tapa, mayor será la temperatura dentro del bote al apagar la luz, como se ve en los resultados de la tabla, y lo mismo sucederá cuando se acabe la radiación solar al anochecer. La temperatura será mayor y se mantendrá el calor en el interior de la caseta por más tiempo.
es_3IHR8NYAM9E5KPNR72IJH4Z7FB9P4J	negro :: El Color Negro afectara la caseta hacienda que la luz sea mas fresca.
es_3II4UPYCOLK3KX7Z0QY1KDJNWT8QDP	gris claro :: La diferencia en temperatura entre el blanco y el gris claro es muy poca y el perro disfrutaría mas el color gris ya que ellos no ven en blanco y negro.
es_3IJXV6UZ1ZWK492L5JOCG095LP1IRE	blanco :: El color blanco garantiza una temperatura menor en el interior de la caseta del perro, esto de a cuerdo a los resultados que arrojaron los experimentos realizados. Los colores grises provocarían un leve incremento y el color negro la temperatura más alta.
es_3IOEN3P9S9WGIK835O08D61N9XV16L	negro :: Porque cuanto más oscuro es el color, más aumenta la absorción de energía y, por lo tanto, el resultado es negro.
es_3IQ1VMJRYVXZURN1ZEWD8HLS1139A2	blanco :: desde los resultados, el color blanco es lo de cual la temperatura no vas subiendo tan como la tapas de otros colores.
es_3IRIK4HM3CX05NI1LLPSU2KEFFEC6M	blanco :: El blanco es el que tiene la mas baja temperatura en unos de los estudio a comparasion de los demnas de los experimentos.
es_3IXQG4FA2VB4D1ST5SW93S5YIBZ9BR	blanco :: Este es el color mas indicado, ya que no acalorará demasiado al perro, puesto que el color blanco no eleva tanto la temperatura como el color negro o mas oscuro. Claro que también debería de tomarse en cuenta la temperatura externa. En lugares mucho muy friosfrios lo mas indicado es utilizar el color negro, y en lugares calurosos lo es el blanco. Saludos.
es_3J88R45B2IBWIRB1RDKOEFW56MRPX5	negro :: si hacen una caseta con la tapa negra, la caseta va ser mas caliente, debido que el techo absorbe mas calor
es_3J88R45B2IBWIRB1RDKOEFW57N7PXO	blanco :: De acuerdo con el experimento, blanco es el color que se ha menos propagado el calor. Otro color sería muy caliente para el perro
es_3JBT3HLQFAFLNMBGSV89B0CGEKSZPB	gris oscuro :: Este color dio como resultado 48 todas las veces, por lo que la temperatura de la caseta se puede controlar teniendo en cuenta que no varia
es_3JJVG1YBEDALCEQH22JSRC0WWFPB5B	blanco :: Entre mas obscuro el color, mas energia absorbe y genera mas calor. Entonces el blanco seria la mejor opcion.
es_3JPSL1DZ5UCKJTRV0OFIQIGC6JTNAA	blanco :: cuanto mas claro es el color de la caseta, menos aumentara la temperatura del aire dentro de la caseta, porque los colores claros absorben menos energia.
es_3JV9LGBJWVR3B54AN3751TRKXB9OGD	blanco :: el color blanco, mantiene una temperatura baja la casa de los perros con el calor de su cuerpo necesitan un lugar fresco porque la casita es cerrada el blanco mantiene una temperatura baja y el perro no estara tan caluroso.
es_3JWH6J9I9UQP23WN62FELT0IP4SBNE	blanco :: Usar el color blanco resultara en una temperatura mas baja en comparacion con otros colores y sera mas comodo para el perro.
es_3K4J6M3CXG6E91A9DK2N0Y7F47OAG5	blanco :: Viendo los resultados obtenidos en el experimento, podrías suponer que los hechos demostrados en este actuan también en la caseta del perro. Considerando esto, si la caseta del perro se pinta con un color oscuro la temperatura del interior de esta ascenderá igual que en el experimento, en cambio si se usa una pintura más clara, como por ejemplo, la blanca, se podría reducir la temperatura del aire interior.
es_3KGTPGBS6ZY89GG0KAYPYVP81W8U2P	blanco :: Blanco, porque es el color que menos calor atrae ya que cuanto más oscuro sea un color más calor absorbe.
es_3KJYX6QCMBO8SR38WLEMTYD8HF1VJ2	blanco :: el color blanco al ser un color claro no absorbe tanta energía, Según la tabla de datos. el color blanco tiene las temperaturas mas bajas siendo así el mas favorable
es_3KMS4QQVK43E7EN0ER9UCRAZ92TFKY	negro :: La tapa esta negra, entonces el color estara mas alto. El seccion 'Datos' enumera el relacion entre temperetura y color.
es_3KRVW3HTZPYI17SP5NM9Y3LIM4CSM6	blanco :: Dado que el blanco es el color mas claro, absorvera menos energia y habra menos calor el la caseta
es_3KWTYT0872GXPNCTTF8M5FW1FHM5LY	gris oscuro :: gris oscro
es_3L0KT67Y8GTIVOH3OQAKSY8PVBKSYK	blanco :: El color blanco resulta ser el que mejor aisla la concentracion de calor lo cual es optimo para dias y/o noches calidas, en caso de ser invierno se puede optar por una opcion distinta a la de la pintura para ser usada como aislamiento y proteccion contra el frio.
es_3L0KT67Y8GTIVOH3OQAKSY8PZV2YSG	blanco :: Porque el color blanco proporciona energía y también da una forma estética de la casa
es_3L2IS5HSFCV4Y25T6TW9QJS6DT8NUN	blanco :: Eligiendo el color blanco causa que la temperatura este estable.
es_3LEIZ60CDLC0VZV9B6CCPAC19DIZ9I	blanco :: Según los datos arrojados por el experimento de Brandi y Jerry, la Tapa Blanca fue la que la temperatura dentro del recipiente aumentó menos. Asi que un techo (y paredes) de color blanco para la caseta de un perro la mas indicada sería la mas indicada para el confort de la mascota. Sin embargo el planteamiento no dice en que condiciones se usará la caseta. Tal vez en una zona en temperaturas bajas (Alaska por ejemplo), una caseta con techo oscuro, podría ayudar a mantener una temperatura mas adecuada para la mascota.
es_3LJ7UR74RJQ5H4BERN5RDFUCFN4N4Z	negro :: negro seria mejor
es_3LO69W1SU5QV5K1DABRD9CNQ3DELGI	blanco :: El resultado del experimento demuestra que entre mas oscuro el color de la superficie, mas caliente es el interior, mientras el objeto recibe luz. Elijo pintar las caseta blanca para que el interior no se caliente demasiado para mi perro.
es_3LRKMWOKB7UPVFAAQ\nFN4N5I92ZI	blanco :: El blanco repele  la luz solar y por tanto el calor
es_3LRKMWOKB7UPVFAAQ\nFN4N7SB2Z6	negro :: Las pruebas realizadas en el experimento confirman la hipótesis de Brandi y Jerri: la temperatura del recipiente fue mayor cuanto más oscuro era el color de la tapa que estaba colocada junto a la fuente de calor. De este modo, el color negro, por ser el más oscuro, absorbe más energía y es el indicado para conservar mejor el calor recibido por la caseta de perro, por ejemplo, por la radiación solar.
es_3LRLIPTPESMJBN6S3BN2YQZ8BVQKAH	blanco :: El color blanco es el mejor color porque permite que el calor se refleje desde la fuente y sólo una pequeña cantidad de calor se transmite en el interior. Con base en los resultados del experimento muestran que el color blanco tiene la temperatura más baja dentro del frasco y hace que el perro cómodo en comparación con otros colores.
es_3LUY3GC631D23C5A90GQKGJH4R47PG	gris oscuro :: La pintura gris oscuro mantiene la temperatura constante.
es_3LWJHTCVCEZ0IHLVRWTR8DM8FWYFQM	gris oscuro :: La temperatura no es muy caliente ni frio con el color gris oscuro
es_3M68NM076JK4BP7K3IFNJXJ0AVAR6P	blanco :: El blanco le dara menos calor a la caseta ya que es el color que absorbe menos energia del calor.
es_3M68NM076JK4BP7K3IFNJXJ0AVM6RG	blanco :: EL COLOR BLANCO REFRACTA LA LUZ POR LO QUE SE CALIENTA MENOS. MIENTRAS QUE CUANTO MÁS OSCURO ES EL COLOR MÁS LUZ ATRAE Y MÁS CALOR CONCENTRA.
es_3M81GAB8A2WA509FMU7VPNVNUKCQBN	blanco :: El color blanco seria mas reflectivo y por lo tanto bloquearia parte de la luz solar durante el dia, lo cual permitiria que la temperatura sea menor en el interior de la caseta.
es_3MHW492WW2QYTZ9TZIRE9Q5PL47MVY	blanco :: Mientras más claro es el color menor será la temperatura y más còmodo estará el perro.
es_3MMN5BL1W1HEHQ7AF8L8QVD615V3MC	blanco :: Por escojer el color blanco la caseta del perro no debe estar tan caliente.
es_3MMN5BL1W1HEHQ7AF8L8QVD6USO3M8	gris claro :: Gris claro es el mejor color para la caseta porque la temperatura no es muy baja ni muy alta y puede ayudarle a adaptarse a diferentes temperaturas del exterior.
es_3MMN5BL1W1HEHQ7AF8L8QVD6WO1M3Y	gris oscuro :: De ninguna manera. dado que no interfiere con la temperatura dentro de la caseta para el perro.
es_3MTMREQS4XVA6N09SP65M1T3Z4CWA7	negro :: El negro se calienta mas de acuerdo a los resultados.
es_3MX2NQ3YCB7SPHTI7YBAG9ROF0TX5M	blanco :: Yo elegiría el blanco, para que el perro no pasase calor, el blanco es el que menos aumenta la temperatura, incluso la puede aislar, por lo cual sería una buena elección escoger el color nombrado anteriormente.
es_3N1FSUEFL7DWVSK12TROHAIIZA64DI	blanco :: Segun los resultados del experimento, la temperatura del interior del bote se mantuvo en menos grados cuando se uso la tapa blanca. Por lo tanto, han demostrado que los colores oscuros efectivamente retienen mas calor y que los claros retienen menos calor. Usando blanco para la caseta del perro mantendra la temperatura interna mas fresca que si fuera de un color oscuro.
es_3N8OEVH1FT3R3IL8BMKD620MRHUOO1	blanco :: blando
es_3NG53N1RLXW63QATJ58WYGFCGJH8PS	negro :: El color negro tiene la temperatura más alta en los resultados del experimento.
es_3NG53N1RLXW63QATJ58WYGFCGMM8P3	blanco :: Colores oscuros absorben mas luz y sera mas caliente para el perro.
es_3NKQQ8O390IVCQEGHZI6UEGCYKMDU0	blanco :: La caseta se va a mantener mas fresca por que el color blanco es el color que menos elevo la temperatura dentro del envase de cristal. Si ellos utilizan el color blanco, la casa del perro estará mucho mas fresca al encender la lampara (si es que va a tener lampara dentro de la casa) o simplemente con la luz solar. Como se muestra en los resultados los dos colores con la menor variación de temperatura son el gris claro y el color blanco. La diferencia entre el blanco y gris claro son apenas unos grados centígrados, pero por cosas eficiencia y máximo aprovechamiento de la baja temperatura, lo mejor seria utilizar el color blanco. \nPero tambien seria ideal utilizar el color negro en caso de que el perro este ubicado en un ambiente muy frio donde las temperaturas suelen bajar en la noche o hasta durante el dia, el color negro le ayudaria a conservar el calor de una bombilla dentro de la casa.
es_3NKQQ8O390IVCQEGHZI6UEGCZ25UD1	negro :: 1/ pnerli la ta pa negra con eltermontro enganchado , ale bote de cristal 3/ asegurase de qui temperatura inicial dentro del bate es de 24 c \n3/ poner la lampara scentimetros de distancia de la tapa y encenderia \n4/ despues de 10 min , medir la temperatura de laire dentro del bate cristal ponotarlo con prueba
es_3NKQQ8O390IVCQEGHZI6UEGCZ27UD3	blanco :: Cuanto más claro sea el color de la caseta menor será la diferencia de temperatura alcanzada en el interior de la caseta.
es_3NPI0JQDAQIP1A2HM3JRPCBZTRGPT1	gris claro :: El gris claro sería un buen color, ya que no hace que la caseta esté demasiado calurosa ni demasiado fría. De todas maneras, este experimento es orientativo de lo que podría resultar en una caseta, ya que no va a estar 10 minutos debajo de una lámpara. Aún así, un color intermedio sería lo más adecuado en mi opinión.
es_3NPI0JQDAQIP1A2HM3JRPCBZX90PTP	blanco :: Se debe de usar pintura blanca para conservar una temperatura más baja y se mantenga un ambiente fresco dentro de la caseta del perro, ya que según el experimento el color blanco hace que se caliente menos el interior que si se llegasen a usar colores obscuros.
es_3NQL1CS15TLYNGY7ILFP3LSW208VY0	negro :: La tapa negra resulta en mas caliente temperatura durantemente todos los experimentos. El color negro obsurbe mas calor.
es_3NVC2EB65SCEB7WOYB9JKQ0D3XC3YY	blanco :: El mejor color es el blanco que retiene menos calor. De esta manera, el perro de los dos niños no morirá de calor.
es_3O7L7BFSHG2VV5XGJD4CHTAM70SEIF	gris claro :: grise claro
es_3OE22WJIGK1P1ZILMLOQUDNBM53UQV	gris claro :: La temperatura inicaial era de 24 c en todas las pruebas
es_3OF2M9AATI1KCVE0F331FJQHMHBZKF	blanco :: La casa quedaría más fría con el color blanco.
es_3OF2M9AATI1KCVE0F331FJQHR6QKZY	blanco :: El color blanco es el que absorbe menos energia, y por lo tanto, la temperatura del aire dentro de la caseta sera el mas bajo. Los resultados de las pruebas  comprueban la hipotesis.
es_3OHYZ19UGEI21ER713FV57GHWVJOAF	blanco :: Pintando la caseta de blanco se mantendra mas fresca ya que los colores claros conservan menos el calor
es_3OLF68YTNBE8V1EE20W5ID73AQ8FAY	negro :: porque ese color tenia mas puntuacion.
es_3OLQQLKKNU2RQGHM1VPCTUPMNS3EJ6	gris claro :: El color blanco refleja la energia radiante en cambio el color oscuro como gris o negro la absorbe. Cuanto mas caliente este el techo mas caliente estara dentro de la casa. Por lo tanto escogi el color gris claro asi el interior de la caseta no esta ni muy fria ni muy caliente.
es_3OS4RQUCRBSDEBJ68EW1DOR9Q3VBFF	blanco :: Mucho menos calor
es_3OSWBBLG1GANTU8BM4TTELFGTX0XD0	blanco :: Usando los resultados del experimento, yo determine que el color blanco seria la mejor option. Comparado a los otro colors, blanco produce la menor cantidad de absorción de calor.
es_3OVR4I9USRWQK1O67FX8H9PHMC44QA	blanco :: Elijo blanco porque los datos de las tres pruebas muestran que la casa sería una temperatura más fría que mi familia prefiere. Vivimos en Texas, donde la mayoría de los días son cálidos.
es_3OWEPKL08BP20RTXTL3YGREM4BB7NQ	blanco :: El color blanco seria el ideal, pues entre mas claro, habrá más frescura dentro de la casa del perro, pues los colores claros absorben menos energía, es decir se mantendría un ambiente no tan caliente
es_3OWEPKL08BP20RTXTL3YGREM4LIN7X	blanco :: en base la tabla encuentro que el color blanco otorgara una temperatura hambiente mas baja, de esta manera el perro de brandi y jerry podra estar mas comodo y fresco, la otra opcion podria ser el gris claro pues la diferencia entre temperaturas no es muy grande, negro definitivamente no es una opcion el incremento de temperatura es muy alto.
es_3OXV7EAXLG3CSNMISSER1ZGK4IQ36V	blanco :: Cuando ellos pintan la caseta para su perro, les importan los efectos del color en la temperature adentro.  Un perro va a sufrir mucho (e posible morir) en un ambiente que tiene demasiado calor, y se necesita una caseta que no absorbe tanto calor.  Por el experimento, podemos ver que las tapas mas oscuras conservan mas calor (por todas las pruebas), y la tapa blanca conserva lo menos calor.  Por eso, vemos que blanco es el color mejor si buscamos una pintura que va a tener lo mas frio despues de mucho tiempo en el sol.  Y una temperatura menos caliente sera mejor para el perro.
es_3P59JYT76NXT931BK58FTZ36NL62TM	blanco :: el blanco sería bueno, porque si la temperatura ambiente esta 24 grados significa que ya esta una temperatura agradable y no hay que calentar más, entonces el blanco mantendría una buena temperatura para el perro
es_3PDJHANYK7TRMVTH7D3T5THUNM96H4	blanco :: El color negro absorbe mucho calor, no permitiendo que la luz y el calor se escape, es por ello que la temperatura dentro de la caseta aumentaría en el caso del color negro. Es por eso que elijo el color blanco para dar mas frescor a la caseta.
es_3PDJHANYK7TRMVTH7D3T5THUSW1H6W	blanco :: el color blanco reflejar la luz y entonces la temperatura es más baja.
es_3PEIJLRY6V6M20823ZYJ6941298WX4	negro :: CREO QUE EL NEGRO RETENDRIA LA TEMPERATURA POR MAS TIEMPO
es_3PEIJLRY6V6M20823ZYJ69412R5WX1	blanco :: De acuerdo al experimento, el blanco es el color que menos aumenta la temperatura del lugar, en este caso, la caseta. El perro se va a sentir mas cómodo en un ambiente mas fresco, aunque la caseta necesitaría ventilación adicional.
es_3PEIJLRY6V6M20823ZYJ6941ZPWXWM	blanco :: El experimento demostró que el color Blanco hace que el aire en el interior sea menos caluroso, por lo que se podría pensar que poner el techo blanco puede ayudar a que la caseta para el perro sea más fresca para él
es_3PIWWX1FJLJZ1W3EFW03QA2ERNMJJS	blanco :: La va a mantener lo mas fresca posible.
es_3PJ71Z61R6F303A13V3KXGSPW0Q19K	blanco :: La lámpara solo puede alcanzar una cierta temperatura.
es_3PJ71Z61R6F303A13V3KXGSPZAJ190	blanco :: Con este color, la caseta absorberia menor energia, basandonos en los resultados del ejercicio, por lo que la temperatura del aire dentro de dicha caseta seria la menor posible, por lo que seria mas comoda para el perro.
es_3PWWM24LHUBABJ9NH7XK237J58X82B	blanco :: para un mejor confort térmico de su perro debe utilizar la tapa blanca
es_3PZDLQMM0VYCNMZ0YJDP4P32U3R2CR	blanco :: Será el color que mantenga la caseta más fresca.
es_3Q5C1WP23OEKZG8P05Q3L0NNA4J155	blanco :: El color blanco absorbe la menor cantidad de energia, por lo tanto, la temperatura dentro de la caseta seria mas baja en comparacion a otro color mas obscuro. Este mismo razonamiento es soportado por el experimento con las tapas de diferentes colores.
es_3QEMNNSB2ZCTEF2K4RPVKM2SR19D73	gris claro :: Cuanto mas oscuro es el color del exterior mas absorbe la energía, siendo el blanco el color que menos energía absorbe y el negro el que mas. Por lo tanto en verano un color negro haría que subiera mucho la temperatura del interior, mientras que uno blanco haría mas agradable la temperatura interior. En invierno seria al reves un color oscuro seria mas interesante, por lo que quizás un color intermedio seria lo ideal.
es_3QIYRE09Y5UOP5EV45MPFHN91OS1N2	blanco :: Según los datos. los colores oscuros absorben mayor energía. Por lo tanto un color mas claro seria el indicado , ya que tiene las temperatura mas bajas.
es_3QJOXOW4XL4HRON74S249MH3M8HEMW	blanco :: Si el clima donde vivira el perro el calido, el mejor color es blanco para mantener el interior mas fresco.
es_3QJOXOW4XL4HRON74S249MH3M9UEMB	blanco :: Blanco es la color com la media de la temperatura del aire dentro del bote de cristal mas baja. Blanco es la color que absorve menos energía entonces haría afectar menos lo interior de la caseta.
es_3QUO65DNQW1MGN5578WM58SB3YYUOK	blanco :: Al pintar la caseta blanca, Brandi y Jerry aseguran que el calor dentro de la caseta sea menor que si la pintaran de otro color. Esto se debe a que su hipótesis fue encontrada como correcta luego de haber hecho los experimentos con otros colores.
es_3QXNC7EIPK83TEPJ7CZKJB9FRLR90M	blanco :: Se toma el color blanco para que la caseta no se caliente tanto por dentro y el perro este mas cómodo, como se ve en los datos de la tabla experimental al tomar un color mas claro, el interior se calentará menos. También es conocido que el color negro u opacos (como el gris claro o girs oscuro) tienden a absorber mas la radiacion.
es_3QY7M81QH9Z1SL8UW8BIOZXID5P7KL	gris claro :: de dia el perro podra levantarse bien y ver la luz clara. Luego de noche el perrito tendra paz para dormir.
es_3QY7M81QH9Z1SL8UW8BIOZXIDGNK7I	blanco :: Si la temperatura de la caseta is igual a la del experimento, elijo el blanco porque 53, 48 y 45  grados es demasiado para cualquier animal.
es_3R08VXYT7E8SNL2BLMULCARDYL0W7O	blanco :: Pintar la caseta de blanco ayudaría a que no se vuelva caliente por dentro en un día soleado, ya que el color blanco reflejará la energía solar más que un color más oscuro. En la prueba realizada con las tapas de diferentes colores, se muestra que de los cuatro colores, el blanco es el que menos hizo que la temperatura aumentara en el interior del frasco.
es_3R0T90IZ1UP22G77XYYE6TX3CZDGC3	blanco :: Blanco porque la casa es más fresca en verano y cálida en invierno.
es_3R3YRB5GRHGXEJB4XPR44D86DF1UAN	blanco :: El color blanco seria mejor para la pintura de la caseta, porque absorbe lo menos energia del sol, y por eso el perro tiene una caseta que no tiene demasiado calor. El experimento muestra claramente que los colores oscuros absorben mas energia y mas calor.
es_3R3YRB5GRHGXEJB4XPR44D86H7GUAQ	blanco :: El color blanco impediría que la caseta se caliente demasiado al recibir los rayos directos del sol, especialmente en verano.
es_3R6BYFZZP9PKREM7DAOJ2LI16Z8XFI	blanco :: Todo depende en la temperature deseada, si viven en lugar caliente es major usar blanco para mantener la caseta de perro mas fresca. Si viven en un lugar frio, negro seria ideal para mantener la caseta mas caliente.
es_3R6BYFZZP9PKREM7DAOJ2LI1BUQXFV	blanco :: El color blanco seria lo mas ideal porque de esa manera cuando el sol toca la caseta no se va a poner muy caliente adentro cuando los perritos estan ahi adentro.
es_3RANCT1ZVHU2XTGW33R0ZOSCVWEUB8	blanco :: Sin importar su color, la mayoría de superficies sólidas que son sometidas a una fuente de calor por radiación absorben calor y lo transmiten a sus alrededores, elevando su temperatura. Pero dependiendo del color que tengan , esas superficies absorberán un grado diferente de calor. El experimento demostró que las superficies con colores más oscuros absorben más calor en 10 minutos que las superficies con colores claros. Por lo tanto, si Brandi y Jerry escogen un color más claro para la pintura de la casa de su perro, más radiación solar será reflejada desde el techo y las paredes, los cuales se calentarán menos y transmitirán menos calor al interior de la casa del perro. Esto es importante porque la luz solar cae sobre la casa, no solo por 10 minutos, sino por muchas horas al día, a veces hasta 15 horas. Pero hay una diferencia: El experimento era hecho con un receptor de calor hermético (cerrado por arriba con la tapa y por los lados y abajo con vidrio). Por otro lado, la casa del perro tiene el agujero donde el perro entra y sale, que permite que el aire entre y salga, haciendo el interior de la casa más fresco.  Puede hacerse una ventanita pequeña, en la pared opuesta a la entrada de la casa del perro, para que el aire efectivamente fluya a través de la casa y la refresque más.
es_3RJSC4XJ127KSRN74MM37V4DA7F05Y	blanco :: El color blanco de la caseta permitira que su interior no sea tan caliente, y asi el perrito no pasara mucha calor en el verano.
es_3RKNTXVS3OBYXLHPIJ0MR9ACGP44AD	blanco :: Brandi y Jerry deben usar el color blanco más claro para el stand para su perro porque entonces el perro no se calentará demasiado.  Las temperaturas para el blanco eran menos que gris claro, gris oscuro o negro.  Así que probablemente sería un buen color de techo.
es_3RRCEFRB7OP3GVMHOX0IMKUI0IA4BH	blanco :: Escogí el color blanco porque entre más oscuro es el color de la tapa, mas aumentará la temperatura del aire y esto seria incoveniente para su perro. Sin duda alguna el color blanco es la mejor opción pensando en el perro. ya que la temperatura aumenta menos.
es_3RRCEFRB7OP3GVMHOX0IMKUIWKVB49	blanco :: Si se utiliza un color oscuro para la caseta, el aire del interior podría calentarse demasiado y axfisiar al perro, por lo tanto, el color elegido es el blanco para que cuando le de la luz del sol, se caliente lo menos posible no llegando a una temperatura peligrosa, según la tabla el color blanco se podría calentar hasta los 43º, mientras que el negro por ejemplo 54...
es_3RSDURM96CZHL5CLNVQF3H4AVIPYE0	gris oscuro :: Me parece que ese color es perfecto ya que el negro es muy caluroso y el blanco no es color para un animal ya que lo ensuciara muy rápido
es_3RU7GD8VPQ6OMAP2X3E1F7FDR2ZSP0	blanco :: El color debería ser blanco, ya que no absorbe tanta radiación y así evitaría que se incremente la temperatura sofocando al animal durante las horas del día debido a la luz solar.
es_3RU7GD8VPQ6OMAP2X3E1F7FDRD6PSQ	blanco :: Para el frio puedo usar mantas, pero el problema peor seria el calor en verano.Asì que si la hago blanca se calienta meno
es_3RU7GD8VPQ6OMAP2X3E1F7FDSP4SPG	blanco :: Elegiremos el color blanco para la caseta del perro, para que así se mantenga más fresca a la luz del sol. Tras las pruebas se observa que la tapa blanca absorbe menos calor que cualquier otro color.
es_3RU7GD8VPQ6OMAP2X3E1F7FDWLJPSO	blanco :: Una caseta pintada de blanco se calienta menos rapido que cualquier otro color.
es_3RWE2M8QWJNOIGTD8MIP1C4ZXYI0NZ	negro :: El color negro afecta la temperatura en el interior de la caseta porque el color negro puede absorber mas calor del sol que los otros colores.
es_3RWE2M8QWJNOIGTD8MIP1C4ZZXKN0O	blanco :: Blanco es mejor porque parece que los otros colores sí absorben más energía. El interior de la caseta del perro se calentaría más con las pinturas de otros colores, en la misma manera que el bote de cristal con las tapas de otros colores se calentó más.
es_3RXCAC0YIT20QDHUGMI9471KEH68GD	blanco :: mas fresco y frio
es_3RXCAC0YIT20QDHUGMI9471KFGX8G3	blanco :: Al escoger el color blanco para pintar la caseta del perro se garantiza un ambiente mas agradable para el animal en vista que acorde a los resultados expuestos en el experimento las temperaturas oscilantes en 41 y 43 grados son las mas bajas en comparación con los demás colores, por lo que el color blanco es el indicado para la caseta canina.
es_3RXCAC0YIT20QDHUGMI9471KGF6G8J	negro :: temperatura del aire on the table categories
es_3RXPCZQMQROIFDX9H19UPXEC4FM1GK	gris claro :: no sera ni muy caliente  ni muy oscuro
es_3RXPCZQMQROIFDX9H19UPXEC4YJG1Y	blanco :: Para no aquecer en demasia la caseta.
es_3SITXWYCNXMUEXAR882NJVRGSDZBXM	gris oscuro :: La temperatura en todos los estudios para el color Gris oscuro seguien igual sin cambiar.
es_3SKEMFQBZ5I5SZDD6D3O2ZTDNL0K8H	gris claro :: Giris Claro
es_3SKRO2GZ734NHZTS7SU9NP659SVK1O	blanco :: Blanco parece ser el color que absorbe menos energía y mantiene la temperatura del aire mas estable, el color mas ideal para la casa del perro es blanco, aun así es necesario algún tipo de material aislante que reduzca la temperatura interna
es_3SLE99ER0PQJJSA69QQ8GG7R1DWBZJ	blanco :: El color blanco afectaría el interior de la caseta haciéndola más fría que si fuese a tener cualquier otro color. Los resultados del experimento indican que mientras más claro sea el color, la temperatura de la caseta va a ser más baja, Ya que a los perros les gustan vivir con temperatura fría, el color blanco sería el más apropiado.
es_3SNLUL3WO60EA228UGGUDROHAFCLUN	blanco :: Tal y como puede apreciarse en el experimento y en los resultados obtenidos arriba cuanto más oscuro sea el color de la tapa mayor temperatura obtendremos.\nPodemos llegar a esta conclusión si tenemos en cuanto las frecuencias de la luz y cuánta luz se refleja. Cuanto más oscuro sea el color mayor luz quedará absorbida y por tanto se obtendrá mayor temperatura.\nEs por ello, que si queremos obtener una mayor temperatura dentro de la caseta deberemos de seleccionar la pintura más oscura, en este caso el color negro. Sin embargo, para evitar que dentro de la caseta haga demasiado calor sería recomendable escoger un color más claro, que en este clase sería el blanco.
es_3T3IWE1XG80A1M3WMGYGPH190L5QTU	blanco :: El blanco atrae menos la energia solar, obteniendo una temperatura menor que el color negro que si atrae mas energia
es_3TEM0PF1Q7AFW420JS4M57S5IZ60DG	blanco :: A primera impresión diría que el color Blanco, sin embargo también depende de la temperatura ambiente del exterior. Con un calor extremo lo ideal sería el color Blanco, y con un frio extremo, lo sería el color Negro. ¡Saludos!
es_3TEM0PF1Q7AFW420JS4M57S5KLQD0N	blanco :: Se planteó la hipótesis de que los colores oscuros absorberían la luz y aumentarían la temperatura. Debido a que la temperatura del aire medida dentro del contenedor se incrementó con colores más oscuros, esto es claro. La transferencia de calor se produce a través de la conducción del techo y la convección del aire interior.
es_3TGOYF991ZZHTSP23U8V4EK0L3SUU5	blanco :: En las tres pruebas, la temperature promedio del color blanco estuvo 10 grados mas baja que la temperatura promedio del color negro. .
es_3TMFV4NEPARWNZ7UVRMRQAN8BBG8WB	blanco :: El color blanco mantendria la temperatura adentro de la caseta baja. La botella de la tapa negra tiene las temperaturas mas bajas.
es_3TOK3KHVJVVKICT9U03BVGERW9F7OI	blanco :: El color Blanco ayudara a reflejar un poco de temperatura fuera del interior pero mantenerlo en buena temperatura en la noche
es_3TOK3KHVJVVKICT9U03BVGERXTOO7D	blanco :: Cuando más oscuro sea el color de la caseta más atraera y absorverá los rayos solares, haciendo que en época de verano la caseta llegue a unas temperaturas insanas para su mascota. Por ese motivo, pintarla de color blanco sería lo más adecuado ya que al estar la caseta en el exterior, los rayos solares no quedarían absorvidos por la caseta.
es_3TOK3KHVJVVKICT9U03BVGERXXDO7A	blanco :: Si usan pintura color blanco, la temperature dentro de la caseta del perro sera menor que si usan otros colores mas obscuros como gris o negro.
es_3TS1AR6UQSRQCZGGVXKL8M5D2IRF7P	blanco :: uno puede notar que entre mas oscuro es el color, mas calor mide el termometro. En el caso de la caseta para tener una temperatura mas baja se tendria que usar el color mas claro posiblemente
es_3TS1AR6UQSRQCZGGVXKL8M5D2LAF7E	blanco :: el color blanco haria la caseta mucho mas fresca para su perro ya que el cuadro indica que es porcentage con menos temperatura
es_3TU5ZICBRFER32B8JINLYL5MK498Q2	negro :: El color negro ayudaría a mantener la temperatura de la caseta mas alta que con los otros colores.
es_3TVRFO09GMS6R6W3ZLRHXYNL680LXA	negro :: El color negro haria que la temperatura dentro de la caseta sea mayor (la temperatura media tras las 4 pruebas es mas elevada). Al ser una caseta de exterior (y suponiendo un clima frio), el color negro seria el adecuado.
es_3TVSS0C0E3DFLJZIYPXMH6JVR5JWT6	blanco :: según los resultados del experimento el color blanco genero menos calor dentro del recipiente en base a los resultados se toma la decisión por el color blanco
es_3U088ZLJVM6E5A2R0N9CXVHQU3X0WR	negro :: NEGRO COLOR
es_3U0SRXB7CFICIADC2Z14L85M5MPNRN	blanco :: La pintura blanca refleja mucha mas radiación proveniente de la lampara, por lo tanto el interior de la caseta se mantendrá a menor temperatura que si se usara la pintura negra.
es_3U4J9857OGO0ZI40QVYPPWESQRY7BF	negro :: La temperatura de la caseta utilizando el color negro va a ser mas elevada porque después de tres pruebas este es el único color que a desmontado constantemente de tener una temperatura de mas de 50 grados celsius.
es_3U4J9857OGO0ZI40QVYPPWESSJ0B77	blanco :: Es importante que el interior de la caseta esté fresco, ya que puedes anadir una manta en caso de que esté demasiado fría, pero es difícil reducir la temperatura. Como el experimento demostró que el color blanco causaba el interior más fresco, deberían pintar la caseta del perro de blanco.
es_3U5JL4WY5MMATYPITTS0BHLAFMDX4W	blanco :: Creo que, si la caseta de perro está pensada para proteger al perro del calor y el sol, la tapa debería ser blanca porque absorvería menos energía y por lo tanto su interior estaría más fresco. Si, por el contrario, la caseta es para resguardar al perro del frío, en ese caso la tapa debería ser negra, absorvería más calor y luz y el interior estaría más calentito.
es_3U5NZHP4LTFZW1BMM922BT8BNCMPHR	blanco :: según puede comprabarse en las pruebas, el color blanco es el que menos aumenta la temperatura interior del bote por lo que aplicando esa regla al color de la caseta del perro, el ideal es el color blanco, el cual se ha demostrado que es el que menos aumenta la temperatura interior.
es_3U84XHCDIEQZYTPXUBGL821LSUR4Z1	blanco :: Mientras mas oscuro el color de la tapa, mas sube la temperatura dentro de la caseta.  Para el animal es menor que la temperatura sea estable y no suba abruptamente, mientras mas claro el color mejor
es_3U84XHCDIEQZYTPXUBGL821LSXAZ4L	blanco :: Si se desea repeler el calor exterior dentro de la caseta, el color adecuado sera el blanco por su poca capacidad de absorción de energía calorica, según lo expresado en el gráfico realizado como resultado del experimento previo
es_3UN61F00HY28SL76YZ5IRR50HEVR50	blanco :: los resultados de la prueba indican que el blanco fue el que absorbio menos luz, y por lo tanto se calento menos. Es por eso que tiene la temperatura media mas baja.
es_3UOUJI6MTFR9AWJX8ZJIOLJ4H0KXU7	gris claro :: negro
es_3UXUOQ9OKGAVG8Z8KHYTULUMDW0A7P	gris oscuro :: El gris oscuro sería un excelente color para el exterior de la caseta para los perros pero afectaría la temperatura interior cuando esté expuesta al sol ya que conforme a los resultados del experimento el color gris oscuro tiende aumentar la temperatura del aire interior.
es_3V5Q80FXIZ4OAM3H5Q2OBMZ8OC623T	gris oscuro :: Esta color es mejor que el negro porque mantiene la temperatura a nivelas comodos para la mascota. El negra seria muy caliente porque el cuerpo de la mascota es mas caliente. El gris oscuro no sera muy caliente pero si mantineria la temperatura mas regulada.
es_3VA45EW49P067QE75KM2U6NESX01OJ	gris claro :: Según los experimentos, el color blanco refleja mucho la luz y reduce la absorción del calor. En un ambiente en el que el perro quisiera mantenerse fresco a la sombra, el color blanco es el ideal, dado que permitirá que el interior de la caseta se encuentre a menor temperatura que si estuviese pintado de negro.
es_3VAR3R6G1REOIQYS45VH9GAM6N18O9	blanco :: con ese color la casa quedará más fresca
es_3VAR3R6G1REOIQYS45VH9GAM8D3O89	negro :: El color negro tenia los resultos mas grandes de los demas.
es_3VBEN272MMCI9XW3UKOELY1LQB5SGP	gris oscuro :: le va a dar mas xalor a la caseta por que la energia solar entrara mas al interior por ser mas oscura. Tambien fue el color que quedo de igual puntaje asiq ue la variedad seria la misma
es_3VHP9MDGRPXWOGBCMESWO8XRA75FC4	negro :: el color pudea sea  blanco
es_3VP0C6EFSI9DE9USYAJ6XYPQCS0M6X	negro :: el negro puede afectar el interior de la casa, aumentando la temperatura del ambiente, tuvo la mayor media de temperatura después de 10 minutos dentro del bote de cristal.
es_3VP0C6EFSI9DE9USYAJ6XYPQCX76MY	blanco :: Según esta tabla el color perfecto es blanco. Debido a que las pruebas 1 y 2 y 3 son la combinación perfecta en este color, los medios también combinan perfectamente. Así que pintar jerry es perfecto elegir es blanco.
es_3W8CV64QJ4CE4EVF5K65P38WE8G9HO	blanco :: Evita el aumento excesivo de la temperatura dentro de la caseta , garantizando un ambiente mas cálido para el perro.
es_3WAKVUDHUYTFVHD6QMFKUM6GC9ZU74	gris claro :: La casa del perro no debe sobrecalentarse, así que debo elegir un color claro. Con el gris claro ltemperatura va a ser fresca, pero no demasiado fría. Hay aproximadamente 12 grados de diferencia entre la temperatura más alta (negro) y la temperatura más baja (blanco). Es un cambio muy drástico, y una casa blanca puede ser demasiado fría en invierno. Por eso elegí gris claro.
es_3WAKVUDHUYTFVHD6QMFKUM6GCOSU7R	gris claro :: GGRIS CLARO PORQUE MANTENDRIA LA TEMPERATURA CONTROLADA
es_3WI0P0II6353WYMZD5N1P3TSTGQRDA	negro :: El color negro absorbería la luz
es_3WMOAN2SRDA4BHUTBJ6EM5UPQ0FVNH	blanco :: Definitivamente el color negro absorbe la luz y calor que irradia la lampara, es por eso que para mantener mas fresca la caseta es mejor usar el color blanco.
es_3WOKGM4L73T601TP91I2G144QZFO0F	blanco :: El color blanco generalmente refleja la luz en lugar de absorberla. Aunque el experimento muestra que el aire de afuera todavía se calienta, pero nunca sube al nivel del negro. Creo que si la temperatura permanece más baja en el exterior, también se mantendrá más fresca dentro de la caja.
es_3WQQ9FUS6C74ZW9J00QV3WAN05R8BD	blanco :: alto contraste
es_3WR9XG3T65OGEJJRBGO2HI8MJNH47L	negro :: Usar una tapa de color negro podria aumentar la temperatura de el interior de la caseta. Basado los resultados de el experimento, podemos observar que el interior con la tapa negra muestra la temperatura mas alta conistentemente.
es_3WRFBPLXRC1KZ8SAR9083A260GV3N2	blanco :: Si el color es blanco, habrá menos calor en el interior de la caseta porque los resultados demonstran que si el color es mas claro, la tapa absorba menos calor. Yo asumo que Brandi y Jerry no quieren que su perro muera por hipertermia.
es_3WYGZ5XF3YSNBJSMKB9TJQTE0PVSKY	blanco :: Al elegir el color blanco para la pintura de la casa, es menos caliente y más cómodo para el perro. O bien, al elegir un color más oscuro como el negro, la temperatura dentro de la casa aumentará, lo que no es bueno.
es_3WYGZ5XF3YSNBJSMKB9TJQTEXSNSKT	negro :: de seguro el color negro  absobera mas energia por lo tanto calentando a mas temperatura el interior
es_3X08E93BHXVBP690BUCP82S4F6B66I	blanco :: Si cuanto más oscura es la tapa del bote más calor se condensa dentro del recipiente, la caseta del perro tendría que ser de color más claro posible para que los rayos del sol no hagan que la temperatura suba.
es_3X1FV8S5JZ4Y1PD7OFTJWLLSSLZGVX	blanco :: Basado en los resultados entre mas oscuro el color mas afecta la temperatura.  El color blanco demuestra de que fue el que menos fue afectado.
es_3X3OR7WPZ1DGC5VVRDFPHZ6SF8RL8K	blanco :: La caseta de el perro deberia ser comoda. El color blanco absorbe menos calor y por eso el color blanco es las mejor opccion. Lo mas oscuro lo mas que absorbe el calor, segun los resultados.
es_3X4JMASXCOMMH74G5WDGAH45JU9B0Z	gris claro :: GRIS CLARO ES LA MEJOR OPCIÓN PUES SI HABER FRÍO EL PERRO ESTARÁ PROTEGIDO DEL FRÍO Y SI HABER CALOR EL PERRO TENDRÁ UNS MEJOR TEMPERATURA EN SU CASETA.
es_3X4MXAO0BI1254MQU0SRHRIDZ6ARWG	negro :: Con el tejado de la caseta pintado de negro y, considerando los resultados del experimento, se puede dar por hecho que la temperatura en el interior de la caseta será superior que con el resto de colores cuando la caseta está bajo la acción directa de la luz del sol. Esta suposición no tiene en cuenta el efecto de posibles flujos de aire en la caseta al no estar ésta totalmente cerrada como el bote del experimento descrito.
es_3X73LLYYQ3RZTGZ96UPA743GL3PHN1	blanco :: esta repuesta es facil sere breve en mi universidad en la clase iluminacion de interiores apredi lo antes ya dicho lo colores claro son lo mejores para la parteinteriores porque dejan esparcir las temperatura y la luz emitidas por lampara.
es_3X73LLYYQ3RZTGZ96UPA743GNXGHNI	gris claro :: Dependiendo del tamaño y la raza de nuestro perro diferenciaremos 3 tipos de casetas para perros: Casetas para perros grandes, casetas para perros medianos o casetas para perros pequeños.\nLa caseta perfecta para tu perro es la que permite que entre sin ningún tipo de problema, pueda levantarse dentro, poder dar una vuelta cuando esté en su interior y acostarse.\nSi el perro no puede realizar estas cuatro condiciones, la casita que habremos comprado será demasiado pequeña y nuestra mascota se sentirá incomoda. Si por el contrario, compramos una casita para nuestro perro demasiado grande, será más difícil de calentar y nuestro perro podria llegar a tener frío, sobre todo en invierno donde las temperaturas suelen ser más extremas.
es_3X87C8JFV8O9MMQHXGTQFC5NX7HQS4	blanco :: Asumiendo que el sol se encuentra directamente sobre la caseta, basándonos en los resultados del experimento, el color ideal es el blanco, ya que permitirá la menor temperatura posible para el perro en días calurosos.
es_3XC1O3LBOUZZAPNJUBQK8V2FOBWLT4	blanco :: El blanco es el mejor color porque para mantener una temperatura más agradable para el perro.
es_3XIQGXAUMEL7CL71VRQ7ET5K667X7K	gris oscuro :: se color podría afectar al interior de la caseta. Usa los resultados del experimento
es_3XXU1SWE8O8HYXZOZIDKF6KZYNI0A6	negro :: Si el perro vive en una region fria el color negro en su caseta puede ayudarle a mantener una temperatura mas calida
es_3Y5140Z9DZTZSWM6SRKNB59QL8PIP1	blanco :: Al ser blanco, es el que menos absorbe la energia, por lo tanto la caseta se mantendra fresa durante el verano caluroso, tal como se demuestra 1 y 3, junto con la media de 41 grados celcius. Si se quisiera para el inverno lo ideal seria el color negro, para asi absorber lo mas que se pueda de energia y mantener la caseta calida.
es_3Y54SXRO1NY2TFAD3PILZIYY3OJUTB	blanco :: EL color blanco absorberá menos energía, por tanto haciendo que el interior de la caseta se encuentre a una temperatura más baja y comfortable para el animal.
es_3Y9N9SS8L0OBDW1X2FM575QCTZO3DW	blanco :: Va a mantener la caseta un poco mas fresca
es_3YDGXNSEO17KEXOALLG8VI4HOCP84I	blanco :: El color tiene un gran efecto en la casa. Cuanto más oscuro sea el color, más caliente estará la casa. Así que el blanco es el mejor color para la caseta del perro.
es_3YDTZAI2WZT23X4PM07TG8H9A9614K	blanco :: La pintura de color blanco absorbe menos energía que la pintura de color gris o negro. Como se puede ver en el experimento, la temperatura dentro de el bote de cristal con tapa blanca fue la más baja comparado con las tapas negra y gris. Por lo tanto, el color de pintura blanco es la mejor opción para la caseta del perro ya que mantendría el interior de la caseta a una temperatura mas baja comparado con la pintura negra y gris.
es_3YDTZAI2WZT23X4PM07TG8H9CYT41Q	negro :: La casa bajaria de valor.
es_3YGXWBAF72UMQ0EN2XWDX400MYO4CW	gris oscuro :: Gris oscuro deja la temperatura al nievel.
es_3YJ6NA41JDTVN76CA95NN6OQZDZJPG	blanco :: el blanco es el color ideal porque no trae ni temperaturas muy frias ni temperaturas muy calurosas.
es_3YMTUJH0DUT3CHGYOJR3ME042S5T4T	negro :: cuanto mas oscuro es mejor
es_3YOH7BII0BK33B9QE6EYUDDL1JBKVZ	blanco :: El color blanco resulto en la temperatura mas baja dentro del bote. Una caseta para un perro estara bajo el sol todo el dia, y debe mantenerse fresca para que el perro este comodo. Por esta razon, pintar la caseta de blanco es la mejor opcion.
es_3YT88D1N0ABJR277UW8SBIL26RC3KV	gris oscuro :: El color y la oscuridad no afectar mucho el interior. Devido a que el color gris oscuro permitira que entre suficiente luz para mantener una temperatura neutral.
es_3YW4XOSQKSY1KVY416YBTCF3DNNU1Z	blanco :: Evitara que la temperatura dentro de la caseta se muy caliente
es_3Z3ZLGNNSK75255271SP74XB4IV3QJ	blanco :: Blanco sería el color ideal para mantener la temperatura de la casa para el perro lo más fresca posible. La selección del color podría afectar en otros aspectos, como mayor visibilidad de suciedad.
es_3Z7EFSHGNBRDO22XM8YIUFXY74HCXL	blanco :: El mejor color para usar es definitivamente el blanco. De hecho, esto evita el sobrecalentamiento excesivo para evitar quemaduras. esto sucede porque el blanco desvía las partículas de luz y se sobrecalienta menos.
es_3Z7ISHFUH280HUCZ6E6YPEHQPAL8ZT	blanco :: El unico efecto del blanco es que en todas las pruebas mantiene una temperatura por debajo de las demas pruebas, ya que es un color claro y la claridad hace que refleje la temperatura y no llega a una alta temperatura
es_3Z7VU45IP0UI6USE7TXJA4UIHVZZ18	blanco :: El color blanco hara que la temperatura en el interior de la caseta no sea excesivamente alta, gracias a que refleja la luz.
es_3ZPPDN2SLX92K44DFJYZ40BJTS39EU	gris claro :: Gris Claro
es_3ZSANO2JCHKCVX08J0IW3D19T52FSW	blanco :: porque entre mas obscuro es el color mas cálido se convertiría el ambiente para la caseta del perro, si se utiliza un color claro como el blanco se calentara menos ya que reflejara con mayor facilidad el calor del sol
es_3ZSY5X72NZOU0VDO3E1H0X5RVV3ROD	gris claro :: Según los resultados del experimento anterior mientras más oscuro el color más calor tendrá el objeto. El gris claro me parece un color apropiado pues el objeto, en teoría, tendría una temperatura regular.
es_3ZV9H2YQQFKAM21OJARVZTFXSMO3W5	blanco :: el color blanco es el que menos absorbe energia, por ende sera el que dara menor temperatura dentro de la caseta del perro
es_3ZWFC4W1UWK0UI0V4BIRD3WD37ERFJ	blanco :: se demostro cientificamente que el color blanco es 22% menos caluroso que el color negro, por lo tanto seria elmas conveniente para la caseta del perro, ya que lo mantendria lo mas fresco posible
es_3ZWFC4W1UWK0UI0V4BIRD3WD3V9RFQ	gris oscuro :: Gris oscuro es la mejor opcion, matiene caliente al perro pero tampoco muy caliente como con el color negro. Al final todo dependera del clima. Si es un clima caliente entonces pintura blanca es  la mejor opcion pero si es frio el ambiente entonces negro o gris oscuro son las mejores opciones.
