id	text
es_308Q0PEVBAQE096ZB2OQPF9BDIFI93	Necesitaría saber cuanto vinagre fue usado en los recipientes y tal vez las condiciones del salón (por ejemplo, el nivel de humedad). Necesitaría también saber que instrumento fue usado para determinar la masa.
es_30LB5CDZNENIZ57WBATJWZB8AAAZ0Y	Seria interesante conocer la densidad del material, la temperatura a la que se realizo el experimento, e incluir un grupo de control con solo agua, y asi poder compararlo con el agua con vinagre que es el agua acida.
es_30ZX6P7VFA8ZV0568BUBRTGXN4EJ21	concentracion del vinagre, temperatura y tipo de vinagre
es_3137ONMDKIIHZERLTP49WHX6SNOEGB	marmol
es_31LM9EDVON5VKMUZUUSVJHJV3MFNJL	1. Necesitaria que saber que tipo de madera, plastico, etc fue usado en el experimenton2. Necesitaria que saber que vinagre fue usado por el estudianten3. Necesitaria que saber si la masa inicial affectara los resultados finales para saber si tengo que usar las mismas masas iniciales
es_31LM9EDVON5VKMUZUUSVJHJVVCBJNL	1. Además del vinagre, necesitamos otro medio ácido de referencia para medir cómo reaccionan los materiales ante este. La sugerencia es que se use zumo de limón , porque es un medio ácido que es seguro de manejar. Hagamos las pruebas con los mismos materiales en zumo de limón así como se hicieron con el vinagre. \n2. Necesitamos un medio de referencia neutro para medir la influencia de la lluvia no ácida en los materiales. Para esto se puede usar agua corriente. Se le puede medir el nivel de pH y si es necesario, agregarle algún ácido o hidróxido hasta que su pH sea neutro. Agregar muestras de estos cuatro materiales en agua neutra, como se hizo con el vinagre y como se haría con el zumo de limón.\n3. Un dato que se necesita para medir la resistencia del material a la lluvia ácida es el porcentaje de degradación al medio ácido, que sería la masa final menos la masa inicial y la diferencia de esa resta se divide entre la masa inicial y se multiplica por 100.\n4. Para asegurar la medición correcta de masas se recomienda usar una balanza manual en lugar de una báscula electrónica.
es_31Q0U3WYDRSZMKM8OY50JK1J18B71J	Utilizar una balanza de alta precisión para resultados acertados en las mediciones. \n Para materiales como caliza o mármol  no utilizar muestras demasiado pequeñas ya que pueden disolverse en su totalidad en contacto con el vinagre luego de 24 horas.\nPara el secado,  las muestras deben reposar en un ambiente seco para evitar reabsorcion de humedad.
es_31Q0U3WYDRSZMKM8OY50JK1J19S712	necesitaria mas muestras, su masa inicial, y diferencia entre masas.
es_31Q0U3WYDRSZMKM8OY50JK1J1IW71O	El grupo debe declarar el tipo de madera y plastico usado ya que hay diferentes como madera de diferentes especies de arbol y plasticos de elasticidad diferented (como el PVC). La temperatura de el ambiente\ndebe ser declarada y controlada para que el experimento se pueda repicar. Tambien la marca de el vinagre tiene que ser declarada.
es_31QNSG6A5T6HXK6TNJEFYUORPHQ78S	Para poder replicar el experimento necesitaría saber las condiciones ambientales en las cuales se condujo el experimento.nTambién necesitaría saber el tipo de vinagre usado en el experimento (acidez).nTambién necesitaría saber el tipo de material de la muestra utilizado. Por ejemplo la caliza usada podría componerse de una diferente proporción de minerales por lo que los resultados podrían variar, así mismo usando otro tipo de madera o de plástico, etc.
es_31Z0PCVWUMS0V4YHQHPAPQKET7DT7L	El alumno debe medir el peso de la muestra antes de reposar durante 30 minutos y secar y medir nuevamente el peso después de que las muestras se hayan asentado durante 30 minutos y se hayan secado.
es_31Z0PCVWUMS0V4YHQHPAPQKEYRV7TQ	El experimento esta completo y no requiere de informacion adicional.\nLas pruebas extras a realizar serían una tara del liquido extraido y una dilusion del mismo para verificar que el material corroido este presente.
es_320DUZ38G9ZPAUDD7QF0TXAYUSNJGV	Sería necesario saber el tamaño del recipiente y el material del que esta hecho y la cantidad de vinagre usado.
es_320DUZ38G9ZPAUDD7QF0TXAYYTGGJR	cantidad de vinagre, temperatura del vinagre, masa de las muestras
es_32AT8R96GNM1EFXYEPDVPD2C8JRUS7	¿Cuánto vinagre se añadió a cada muestra?; ¿Dónde en las muestras se aplicó el vinagre?; ¿Las muestras tienen barniz o superficies terminadas que podrían afectar la reacción con el vinagre?
es_32RIADZISUH2XH3JZJMDC94I3YQS4J	La cantidad de vinagre que se agregó, si las muestras se dejaron en la oscuridad o expuestas a la luz, especificar el tipo de madera , mármol, caliza y plástico que se uso en el experimento.
es_32SCWG5HIJHJZCR5QQBYE2JL9RW6PE	Algunas informaciones importantes serían el tipo de vinagre usado, la cantidad de vinagre en cada recipiente y la temperatura en el momento del experimento.
es_32SVAV9L3HMDFPYLI5V3H4I601DA3P	La lluvia ácida se produce por la interacción de ciertos gases emitidos al aire por las industrias (como óxido sulfuroso y óxido nitroso) al mezclarse con las gotas de agua de lluvia que caen en la atmósfera. 1)  Debido a que hay más de una sustancia que produce dicha lluvia ácida, es conveniente hacer el experimento usando por lo menos un segundo agente ácido demás del vinagre. Ese agente podría ser el zumo de un limón, también ácido como el vinagre y seguro de manejar. Entonces se pueden poner muestras de los mismos materiales en zumo de limón y repetir el experimento y las mediciones. 2)  también es necesario tener un elemento de pH neutro (como el agua) para comparar la influencia de un ambiente ácido sobre las superficies con la influencia de un ambiente neutro, así que se pueden hacer muestras de los materiales y ponerlas en recipientes con agua, lo mismo que ya se hizo con el vinagre y el zumo de limón. 3) Otro dato del experimento que sería útil es el porcentaje de degradación diaria, que se calcula como la diferencia entre la masa inicial de cada objeto y la masa final, dividir esa resta entre la masa inicial y multiplicarla por 100. Como el plazo del experimento son 24 horas, este porcentaje sería de tipo diario. 4) Si con los objetos sumergidos en agua se produce pérdida de masa, esto podría indicar que el aire del sitio donde se hace el experimento es ligeramente ácido y el nivel de acidez se podría medir comparando con los niveles de acidez de las otras sustancias. 5) es importante que, en lo posible la masa de las muestras se calcule con balanza manual y no con báscula electrónica.
es_32UTUBMZ7I92A85W8T15VAUV9E8VB5	Necesitamos la Densidad de cada elemento probado. Cantidad de Vinagre utilizado en cada muestra, expresado en Volumen. Área o superficie del recipiente utilizado.,
es_32Z9ZLUT1NXHB1ZL79PNMT3L8PCOHQ	Necesitaría saber:\n-Tipo de vinagre, si es de vino, de manzana, etc\n-Porcentaje de acidez en el vinagre\n-Tipo de agua destilada, porcentaje de pureza\n-Material de los recipientes\n-Litros de vinagre y agua destilada necesarios\n-Saber el tipo de madera y plástico
es_32ZKVD547H0IYZ3DOJVZCF2CIJU3B9	Veo que en el experimento se quiere ver como reaccionan los materiales al vinagre y qué cantidad de ellos se disuelve. Creo que el experimento está muy claro, quizá se debería especificar qué tamaño de recipiente es necesario, aunque mientras sean los 4 iguales y quepa la muestra debería valer. También estaría bien saber cuánto vinagre echar. No vienen las medidas así que asumo que será la misma cantidad en todos los recipientes y que ésta sea suficiente para sumerger la muestra. Por último, se podría especificar con cuanta agua destilada enjuagar las muestras y durante cuanto tiempo.
es_333U7HK6IBSMYA3M50ESNC71PPZDJT	Según esta tabla, cuatro muestras diferentes y sus masas en esta sección la masa más alta es madera es 0.0 y la más baja es caliza es -1.3 es muy baja y toda la mesa es plástica es -0.1 y mormol es -0.4, así que toda la tabla contiene la masa.
es_336KAV9KYS5PQP05UBVE1GVLZ7QY2A	El tipo de madera tendría que ser conocido para replicar este experimento, especialmente si se usara un barniz para madera. Se debe incluir una medida adicional para mostrar el peso de la muestra húmeda, ya sea en la solución de vinagre o en una balanza inmediatamente después de la extracción.
es_336YQZE83XRHV5UETR915SBQ9DJM50	cantidad de vinagre agregado, concentracion del vinagre utilizado, tipo de plastico utilizado, tipo de madera utilizada, estado del marmol y caliza utilizados, cantidad de agua destilada utilizada para enjuagar, tiempo de enjuague, material del recipiente donde se colocaran las muestras.
es_338JKRMM28CS9X5KXQK5LYJGKREHAT	cantidad de vinagre que se echa, Temperatura de la habitación, material del recipiente, temperatura de secado
es_338JKRMM28CS9X5KXQK5LYJGQI0AHW	Necesitaría saber: la cantidad de vinagre para poner en las muestras; la cantidad de agua destilada para usar; si debo secar las muestras con una toalla antes que pesarlas; el tipo de madera; el tipo de plástico; el tipo de vinagre; el material del recipiente.
es_33CID571066UB8PPFWKTQIYH2C23LW	volumen, densidad
es_33CID571066UB8PPFWKTQIYH3ACL3L	Necesito una pesa, vinagre, y agua distilada para replicar el experimento.
es_33F859I568QXS7AC34K1G93M1PNHB7	dejarlo secar muy bien\ntomar en cuenta la temperatura
es_33FBRBDW6QCN911PE0MQEGG5GRR8CK	diferentes materiales tienen diferentes densidades
es_33JKGHPFYE7LLU0KXR5NZ9BC98QMNQ	aplicar estudio de las propiedades químicas de cada material en estudio.nEs necesario hacer el ensayo en otros tipos de solventes como alcohol, agua, entre otros.nrealizar pruebas con otros otros métodos como maceración, entre otros.
es_33LK57MYLVII0ER8KCC365HRBJAZS6	¿Que cantidad de vinagre se le agregara  a los recipientes?n¿Que tipo de vinagre se utilizara para el procedimineto?n¿Se deben tapar los recipientes?n¿A que temperatura se debe dejar reposar las muestras?
es_33NF62TLXLFUCG9WXH0FRP2R7PNKJK	determinar la masa de cada muestra, después de 24 horas, mojar cada muestra con agua destilada y etiquetar los recipientes
es_33OOO72IVJY67LTDHYXL5CCS5S2TC7	La cantidad de vinagre en cada envase, la temperatura ambiental, y la temperatura de el agua destilada que se uso para enjuagar cada muestra
es_33PPO7FECXSQ3ZJGNITSBBS141VDIC	Qué tipo de madera se utilizó para el experimento? \nQué tipo de plastico se utilizó para el experimento (suave o duro)? \nDonde guardaron los recipientes con muestras (la temperatura, lugar claro u oscuro)?
es_33PPO7FECXSQ3ZJGNITSBBS14OCID8	Necesitaria saber la cantidad de vinagre, la acidez del vinagre, el material de los recipientes
es_33PPO7FECXSQ3ZJGNITSBBS1CSDDIK	Cantidad en mL de Vinagre que se ha vertido sobre las muestras, Información sobre el tipo de recipiente que hayan utilizado para colocar las muestras y tener precisado en cuales condiciones se están trabajando las muestras (presion, atmosfera y temperatura) además de por supuesto tener una balanza para calcular la masa de dichas muestras.
es_33PPO7FECXSQ3ZJGNITSBBS1FDQIDB	¿Cuánto vinagre se tiene que usar?n¿Cuánto material se tiene que usar para la muestra?n¿Por cuánto tiempo se tiene que enjuagar la muestra?n¿Se tiene que secar la muestra por 30 minutos seguidos?
es_33TIN5LC06N0Q9L4FKATB33Z3PN9YM	¿Cuánto vinagre hay que echar en los recipientes?\n¿Qué tipo de vinagre hay que echar en los recipientes?\n¿Cómo secar la muestra si aún está húmeda tras 30 minutos?
es_34HJIJKLP79IP9KNTERINWOP1LX4VE	Para replicar el experimento agregaría:\n- un peso para realizar la medición exacta de las muestras tanto antes como después del experimento\n- describir la forma de las muestras estudiadas\n- determinar la cantidad específica de vinagre a colocar en cada recipiente, para que cada muestra tenga la misma cantidad\n- mencionar por que se escogiendo esas muestra y cual es el objetivo
es_34HJIJKLP79IP9KNTERINWOP8AFV48	1.2 - Toma cuatro recipientes o envaces de la misma porcion o tamano.n2.2 - Asegurate que la porcion de vinagre sea la misma en todos los envaces.n2.3 - Tomas cuantro muestras de diferentes tipos de madera, a estos los llamaremos el material.
es_34J10VATJHBKS8NLS4ZCBAZ0QAGIQ9	Faltaría saber la cantidad de vinagre usado, si ha quedado masa residual resprendida de la muestra y los utensilios necesarios/usados para llevar a cabo este experimento. (También tener en cuenta la porosidad de cada muestra y si esta completamente seca)
es_34S6N1K2ZXW95GWOUH9VUCZRGO8LHI	Voy a necesitar saber cuanto vinagre poner en cada recipiente, que tipo de vinagre, locación en la cual la muestra esta secando durante 30 minutos.
es_352YTHGROXQD78P3OPAE8VXG21I4HJ	Para que el experimento tenga éxito y más exactitud, se debería dar más importancia a los recipientes. Unos vasos de precipitados por ejemplo ya que si fueran de según que plástico se podrían obtener datos erróneos.
es_358010RM5G69NB8XDPTNK7LNY0WVXM	Primariamente, el experimento requiere una lista de utiles. Tambien se necesita saber precisamente cuanto vinagre se usa en los recipientes, y instrucciones de como medir la masa de las muestras para poder replicar el experimento.
es_358UUM7WR1GNFPLPMSKFPBJW5JWR7G	es necesario conocer adicionalmente, 1.- que tipo de madera se utilizo. 2.- la densidad del vinagre. 3.-la temperatura a la cual estuvieron sometidos las muestras,
es_358UUM7WR1GNFPLPMSKFPBJW8E27RV	1. la cantidad de vinagre\n2. una bascula\n3. como secar los materiales
es_358UUM7WR1GNFPLPMSKFPBJWE007R7	Que es el pH del vinagre? Que es la forma de las muestras? Hay un grupo de control?
es_35GCEFQ6I71EGX6TUXB2YX9FI233Z7	Cantidad de vinagre a colocar en cada recipiente, tamaño o peso de las muestras a utilizar y condiciones bajo las cuales se debe dejar los recipientes en reposo
es_35H6S234SCDF629M6B2KGWE4Q0656S	despises ed leer eel proceeding Del groups ,describe Que information additional necessaries  para replica experiment
es_35USIKEBNTTJWRFSABY6ADEQEZH6NJ	1. Tamaño de los recipientes. \n2. Cantidad de vinagre a echar en cada recipiente. \n3. Cómo determinar la masa. \n4. Qué tipo de material. \n5. Tamaño y forma de cada muestra.
es_369J354OFFNDMZY6N7LBKT5TD72G6W	servivrian otras masas, el nuevo tiempo de reposo de las masas y el tiempo de secado de las masas y la cantitad de agua destilada que se debe utilizar
es_36PW28KO419GPNEI7PCZ0VM3TDPAEE	Hay que saber la cantidad de vinagre para echar a la muestra. Tambien, necesita saber la cantidad de material de la muestra para incluir.
es_36U2A8VAG3CK754VJH1I1CHFJOMKYT	1. Cantidad de vinagre que se hechara en los recipientes\n2. Cual sera la cantidad de las muestras?\n3. se seca al aire libre o al sol ?
es_36U2A8VAG3CK754VJH1I1CHFMMQKYW	1. Temperatura del ambiente (si el resultado puede ser afectado por esto)n2. Dónde poner a secar las muestrasn3. La temperatura del agua destilada
es_36V4Q8R5ZMD6ORDCDJX4336H4ACQMO	-Que cantidad de vinagre fue suministrado en cada muestra. \n-Los plasticos tienen diferentes tipos, es necesario conocer que tipo de plastico fue usado en este experimento.\n-Que tipo de vinagre fue usado para el experimento
es_36WLNQG781NL8XJAD3CVV669IV7EBH	Para replicar el experimento se necesita conocer el tipo de madera utilizada, el tipo de plástico utilizado y la cantidad,el tipo y concentración del vinagre utilizado.
es_36ZN444YTTBH7WA5DR78M540GY5IOR	Datos sobre la ubicación geográfica del experimento (Altura sobre el nivel del mar) nCantidad de vinagre usadanCondiciones de temperatura del ambiente
es_373ERPL3YQLADNIWZVNGU7BE4HLTR4	hora exacta de cada recipiente y que tipo de materiales utilizaron pexact time of each container and what kind of materials they used to create this experiment, how many of the elements usednara crear este experimento apaorte de la cantidad de cas elemento utilizad
es_379J5II41QTXL65M4G1P992EU64LES	1. Primero necesitaría saber que cantidad de vinagre usaron para cada muestra, y si es la misma para los diferentes materiales.   2. También me gustaría saber que instrumento utilizaron para medir la masa.   3. Por último, quisiera saber de que material está hecho los contenedores de las muestras donde las almacenaron junto con el vinagre (vidrio, aluminio, plástico, etc)
es_37FMASSAYE4XO2LW9M2MGL4110FBI3	Para poder replicar el experimento, necesitariamos saber que clase de plastico fue usado ya que existen varias clases como el PVC, LDPE (encontrado en bolsas de plastico), etc. Diferentes\nclases de plasticos van a reaccionar diferente al vinagre. La temperatura en la cual el material es secado tiene que ser la misma. Hay que determinar si sera al aire libre, en cuarto con temperatura controlada,\netc. No recomendaria al aire libre ya que se seria una variable fuera del control del grupo. Tambien hay que determinar cuanto tiempo las muestras van a estar bajo agua destilada. En resumen, hay que declarar mas variables controladas como la temperatura, clase de materiales, y el tiempo en cual estan bajo agua destilada.
es_37Q970SNZGLL5I60C13BEBXFSY9S14	Primero indicar las dimensiones (medidas) de las muestras. \nSegundo, indicar la capacidad de los recipientes en donde se sumergirán las muestras. \nTercero, indicar la cantidad de vinagre que se debe utilizar (si debe cubrir completamente las muestras con  el vinagre)
es_37Q970SNZGLL5I60C13BEBXFY431SP	1. Que tipo de vinagre se debe utilizar.n2. Que tipo de plastico se debe utilizar.n3. Medidas de la muestra, superficies, para estar seguros de que la superficie sobre la que hace efecto el vinagre es la misma.
es_37TRT2X24S4TJD52R4NMSMJ1HJZJBT	Pues se ve que la madera es el que menos perdio masa, a pesar de ser porosa por naturalez, a comparacion del material caliza, el cual pudo haberse desintegrado con los solventes, lo cual explicaria la disminucion de su masa. El plastico fue insignificante la masa que se perdio, posiblemente algun error en la medicion, o al haberse deteriorado el material, parte se perdio dentro de los solventes.
es_37TRT2X24S4TJD52R4NMSMJ1OFJJBC	Densidade
es_37UQDCYH6Z8F8W26VCPPQ88ZRBHV7U	Se podría replicar midiendo el peso de siete elementos diferentes con una balanza científica. Utilizando siete vasos de precipitado, se pueden agregar dentro materiales como tela, goma, cartón ,vidrio, aluminio, piedra y cerámica. Se etiquetan, se agrega vinagre y se sellan. Dejar remojar por 42 horas. Luego de transcurrir las 42 hora, utilizar agua destilada para enjuagar los materiales y luego dejar secar completamente. Con una balanza científica medir el peso de los materiales de nuevo y agregar los datos en una tabla. Calcular la diferencia entre masas(g).
es_37WLF8U1WR3IOLUPDY6QILXMJG66KV	CAliza
es_37XITHEISYMTR6GLD9SQ5XBA9JERCH	1. CUanto vinagre poner en cada recipiente.\n2. cuant agua destiilada se deberia de usar\n3. Asegurar que la muestra es la muestra determinada.
es_37XITHEISYMTR6GLD9SQ5XBABRACRG	Cuanto vinagre poner en el recipiente
es_382M9COHEJS04WSGDUTQ0WYXZVRUED	hice los procedimiento y fueron efectivos por un lado logra hacer agua destilada pero tambien pude hacer agua acida una agua que puede ser usada como refrigerante mata insectoy y para acido de bateria
es_38BQUHLA9YD33F0WY650EYBHR3PMOX	1. masa media\n2.Radio de arco (m)\n3. Altura de liberación (m)
es_38F71OA9GV99X2N3Z3MAR4232Q9MF1	Cantidad de vinagre, tamaño de la muestra, cantidad de agua destilada
es_38YMOXR4MWC9JLO62CPT6WRH2A0W68	Para replicar el experimento necesitaria saber la cantidad de vinagre utilizada en cada recipiente, cuanto es la cantidad de agua destilada, cual fue el instrumento que se uso para determinar la masa de las muestras y cual fue el metodo utilizado para secar las muestras.
es_38YMOXR4MWC9JLO62CPT6WRH2HO6WK	Qur tipo de recipiente usaron para echar el vinagre, cuando dejaron el material en el recipiente de vinagre los dejaron en un lugar obscuro, bajo de luz natural oh una lampara. Qur tipo de madera usaron para el experimento.
es_38YMOXR4MWC9JLO62CPT6WRH7KWW6T	Despues de 24 horas,quitar las muestras de los recipientes y enjuagar cada muestro con agua destilada
es_38YMOXR4MWC9JLO62CPT6WRHDXQ6WT	ENLUIR LA CANTIDAD DE LA MESCLA, COMO SE SECA, Y COMO SE OBSERVE LA MASA
es_392CY0QWG34D330NU7SZ87YVRBW4IU	Temperatura\nHumedad\nMaterial de los recipientes
es_39GAF6DQWTD1XAN46W8GPYHMQRO1VG	En primer lugar el tipo y tamaño del recipiente. si es de vidrio, plástico o otro material. El tamaño del Mismo.\nEn Segundo lugar la cantidad o litros de vinagre a echar en cada recipiente.\nEn Tercer lugar, ¿Donde se deja reposar? si es al sol o a sombra, si ese factor no influye por evaporación mayor del vinagre en caso de que sea al sol
es_39GAF6DQWTD1XAN46W8GPYHMSPI1V8	El volumen de las muestras ya que 10 gramos de marmol tendra un volumen inferior a 10 gramos de madera. La clase u PH del vinagre, el proceso de enjuagar (sumergir o no?), la temperatura del ambiente para dejar reposar las muestras
es_39GXDJN2OVRJ8A7P5HHV484U9QA8VE	para poder hacer un cálculo mas certero necesitaríamos saber si la madera está totalmente seca, habría que determinar el compuesto de la caliza en porcentajes tanto de arcilla, siderita, hematita que modificarían el grado de coherencia de la roca. También la resistencia del plástico ya que  según la composición uno podría ser mas resistente que otros.  La masa inicial debería ser igual.
es_39JEC7537WELKDX2MTX06U0DTYXVC1	Se necesitaría como información adicional la cantidad de aceite que es necesaria incluir en cada uno de los recipientes, la densidad de dicho aceite y el volumen de las muestras.
es_39LNWE0K4W9CK1U29DJHLBWPRK4IU8	Mínimo, necesitaría conocer el volumen de cada recipiente, la cantidad de vinagre que se necesita echar, y si ésta cantidad es constante para cada uno de los materiales o es una proporción respecto a la masa.
es_39LNWE0K4W9CK1U29DJHLBWPU9FIU0	1- por que se deben de lavar las muestras despues de sacarlas del recipiente, de alguna forma esto podría afectar los resultados \n2- el volumen y el diámetro de cada masa debería ser identido o no\n3 - Que tipo de vinagre se utiliza para el experimento
es_39OWYR0EPM49RJCHI6ALLZPA6KUFYQ	el vinagre hace efecto en algunos materiales mostrados arriba referente a la masa, en otros casi las propiedades de estos se mantienen igual, el color de alguno de ellos debe cambiar , al igual qu su olor y forma, la caliza debe dformarse algo.
es_39PAAFCODOD26UZD8FSQV40HFFOTVX	Para mejorar las operaciones anteriores, ingrese 1) La cantidad de vinagre vertido en los diversos recipientes.\n2) El tipo de vinagre utilizado. Además también calcularía 3) el volumen de las masas.
es_39RP059MEJ6JKLBNU10E8EBIIGZBMX	Información adicional:\n1. Instrumento para enjuagar cada masa.\n2. Recipiente para colocar las masas.\n3. Medidor de masas.
es_39U1BHVTDN4IULXUO5MKC98YPBCT3E	La cantidad de vinagre (respecto a la masa del objeto), el tamaño del recipiente (respecto a la masa del objeto), material del recipiente.
es_39ZSFO5CAA98FCE8RV4HXCBP3AFJUS	Necesitaría la cantidad de vinagre, el tamaño de los recipientes y de las muestras
es_3A1COHJ8NL8EQ9C50S0RP7DL2NHH84	Ocuparía saber la cantidad de vinagre en cada contenedor. Ocuparía saber el tomaño de cada contenedor. Ocuparía saber los tomaños de las muestras.
es_3A1PQ49WVJUWF9SK17RCAXQDICF1HS	el tipo de vinagre, la cantidad de vinagre usado, cantidad de agua destilada utilizada
es_3A1PQ49WVJUWF9SK17RCAXQDJ1H1H9	el acido acetico del vinagre hizo liviano las masas pero no afecto a la mader.
es_3A1PQ49WVJUWF9SK17RCAXQDJBSH1K	1)especificar cuanto vinagre se pone en cada recipiente (preferencia en ml).  2) especificar con cuanta agua destilada se enjuaga cada muestra. 3) como es el procese de enguajar? 4) El tamano y forma de los recipientes?
es_3AAPLD8UCEUXOT4T3QBMG398BHMHT6	Indicar mistura de vinagre, tempo para esperar e tempo de reposo,  e indicar enjuaguar con agua
es_3ATTHHXXWC1415OXEIU45IVTL9AXII	Cantidad de vinagre, temperatura ambiente y concentración del agua.
es_3ATTHHXXWC1415OXEIU45IVTQZLIXZ	Necesito sbaer que tipo de vinagre usaron y  que tipo de madre se uso, ya que dependiendo de el tipo de madera esta puede basorber mas o menos del liquido.\nQue tanto vinagre le tengo que poner al recipiente?
es_3AZHRG4CU6XHEC03Q3YASY6T2BM30F	No veo preguntas
es_3B1NLC6UG19LW5GB23KKQTWA5SLGPO	Para replicar el experimento, necesitaría saber qué tipo de vinagre se utilizó, la cantidad de vinagre que se depositó en cada uno de los recipientes.\nTambién que tipo de madera y plástico se utilizo, ya que existen varios tipos de estos, y sus propiedades varían.\nTambién sería bueno saber en que ambiente se dejaron reposar las muestras (¿Al sol? ¿A temperatura ambiente? etc).
es_3B2X28YI3YSHVIQV7LTXJIEWSB36BR	"Necesitaría saber el tipo de recipiente utilizado y su tamaño. Necesitaría saber si los recipientes donde permanecen 24 horas las muestras permanecen cerrados con una tapa o descubiertos. Por último, también necesitaría saber en qué dos momentos se miden las magnitudes ""Masa Inicial"" y ""Masa Final"" indicadas en la tabla y cuál es el instrumento de medición utilizado."
es_3B3WTRP3DDFAPOSXMZ3Y2Z2UO4V29P	1. Pese cada una de las cuatro muestras antes de verter vinagre para obtener la masa inicial.\n\n2. Pese cada una de las cuatro muestras después de dejarlas secar, para obtener la masa final.\n\n3. Reste la masa final de la masa final para obtener el cambio de masa de cada muestra.
es_3BDCF01OGZ7VRBMD4HDJGCUUEK0LY4	Para Replicar el experimento se necesitarian  muestras de Marmol , Caliza, Madera y plastico ; en  con el mismo peso incial del  primer experimento. Colocar vinagre en cuatro  recipientes donde iran cada una de las muestras.  Despues de 24 horas retirar las muestras  y enguajar cada una con agua destilada. Dejar reposar las muestras por 30 minutos , para luego determinar  la masa decada muestra.
es_3BF51CHDTXNW8K725ONCWS73C6L0H7	¿cual es la temperatura de las muestras?\n¿que nivel de condensación necesita cada elemento?\n¿cual es la formula para determinar la masa?
es_3BV8HQ2ZZYECC8L317T1O7UQK5SA68	cantidad de vinagrenmodo de determinar masantipo de cada material (cual tipo de madera? cual tipo de plastico? ...)
es_3BWI6RSP7IMY6LGK0M0FQ4KDVDEE75	La masa o volumén de vinagre echado en los recipientes, la diferencia entre lá massa del recipiente con vinagre antes de poner la amuestra y despues de colocar la amuestra y los materiales usados para el etudio
es_3BXQMRHWK1BYGKKTUSH9D4367UAMUF	1) A que temperatura ambiente se realizó el experimento.\n2) Temperatura y condiciones de secado.\n3) Cantidad de vinagre que se utilizó en ml.\n4) Cantidad de Agua destilada Utilizada para enjuagar?
es_3BXQMRHWK1BYGKKTUSH9D4367VHMUO	Sería interesante hacer este experimento no solamente con vinagre, sino con distintas sustancias más; Ya sea como leche, agua, aceite. Así podríamos determinar cómo reacciona cada una de las muestras de arriba dependiendo de la sustancia a la que es expuesta. Por lo que se concluye por mientras en este experimento, es que la madera no es alterada su masa al menos cuando es expuesta en vinagre, y la caliza es la más alterada por el vinagre. Saludos.
es_3BXQMRHWK1BYGKKTUSH9D436GLHMUD	como se determina la masa al principio (con que método), como se determina la masa de las muestras al final, de que tamaño y composicion son los recipientes
es_3C2NJ6JBKCUVEQWRN9M3K0XEYZG2N9	Para empezar, para replicar este experimento solo lo único que necesitaríamos sería cambiar los elementos para realizar pruebas que sean diferentes y conseguir resultados que muestren cambios significativos en su masa. Inicialmente podría utilizar elementos como cartón, icopor, vidrio y ladrillo para sacar muestras que podamos meter en tubos de ensayo (son económicos) a lo que agregaríamos vinagre con el fin de no cambiar el liquido con el que se esta realizando el experimento o poner otros líquidos como soda, líquidos de limpieza (clorox-bleach) y agua de lluvia para conocer los diferentes efectos de estos líquidos en cada material. También es importante que tener os elementos para la medición de las muestras que se van a utilizar y así tener los datos iniciales y los datos finales\n\nEste experimento sería recomendable realizarlo en un ligar donde nadie lo pueda mover y que la temperatura no tenga mayor variación para que las muestras siempre estén estables y no hayan mayor efecto en ella cuando se revisen los resultados. Este procedimiento como se puede apreciar en el anterior experimento, debe ser construido y dejado por 24 horas para que el liquido tenga un efecto sobre el material que se esta probando.\n\nAgregaría datos como:\n*Resistencia del material\n*Grupo al que pertenece el material\n*Liquido utilizado
es_3C44YUNSI32IKL6K0DJCK8TD1LOPDL	Informacional adicional necesisarion1. Tipo de madero - son varios tipos de diferente densidadn2. Grado de acidez del vinagre - importanten3. Cantidad de vinagre en cada recipienten4. Los recipientes son tapados por los 24 horas o se deja abiertos
es_3CFVK00FWNYT8RC7YYIRXLA1E006LX	MARMOL
es_3COPXFW7XDPQYRCUSU5ZOLO3JWQPK5	Tamaño del recipiente, cantidad de vinagre y condiciones ambientales (ejemplo: luz y temperatura).
es_3CTOC39K3936H12CENB6NKX5XN6J7S	Es necesario, especificar la cantidad de vinagre, tamaño del recipiente y cantidad de agua destilada que se usa.
es_3D3VGR7TA2S5E6K2KGHPCU7G1D83RE	- ¿De qué material deben estar hechos los recipientes?\n- ¿Deben estar dichos recipientes tapados durante el período de 24 horas?\n- ¿Cuánto vinagre se debe echar en cada recipiente? ¿Deben estar las muestras totalmente cubiertas de vinagre?
es_3D4CH1LGEC604I04LEON43WV7UD9GF	"Lluvia ácidanLa lluvia ácida es una forma de contaminación ácida, que hace referencia a la caída (deposición) de ácidos presentes en la atmósfera a través de la lluvia, niebla y nieve (también conocida como deposición húmeda).nLos principales precursores de los ácidos, son los óxidos de azufre (SOx) y los óxidos de nitrógeno (NOx), que son emitidos por las termoeléctricas, los motores de combustión interna de coches y aviones y algunas otras industrias, como producto de la combustión de combustibles que contienen pequeños porcentajes de azufre (S) y nitrógeno (N), como el carbón, gas natural, gas oil, petróleo, etc.nLos ácidos, principalmente ácido sulfúrico y ácido nítrico, se disuelven en las gotas de agua que forman las nubes y en las propias gotas de agua de lluvia, depositándose en el suelo. Ambos ácidos se originan en la atmósfera al reaccionar el trióxido de azufre (SO3) y el dióxido de nitrógeno (NO2) con agua, oxígeno y otras sustancias químicas presentes. En presencia de luz solar aumenta la velocidad de la mayoría de estas reacciones.nExiste también otra forma de contaminación ácida conocida como deposición seca, y hace referencia a gases y partículas ácidos que son arrastrados por el viento, chocando contra edificios, coches, casas y árboles. Otra vía de arrastre son las lluvias fuertes. En este caso las sustancias ácidas se incorporan a la lluvia ácida, lo que contribuye a aumentar su acidez.nAproximadamente la mitad de las sustancias ácidas en la atmósfera caen al suelo por procesos de deposición seca.n¿Cómo se mide la lluvia ácida?nLa lluvia ácida se mide según la escala de ""pH"", potencial hidrógeno. Cuanto más bajo sea el pH de una sustancia, es más ácida.nEl agua pura tiene un pH de 7.0 y normalmente la lluvia tiene un pH entre 5 y 6, es decir, es ligeramente ácida, por llevar ácido carbónico que se forma cuando el dióxido de carbono del aire se disuelve en el agua que cae. En cambio, en zonas con la atmósfera contaminada por estas sustancias acidificantes, la lluvia tiene valores de pH de hasta 4 ó 3 y, en algunas zonas en que la niebla es ácida, el pH puede llegar a ser de 2 ó 3, es decir similar al del zumo del limón o al del vinagre.n¿Cuáles son los efectos de la lluvia ácida?nLos efectos ocasionados por el agua ácida dependerán de diversos factores, como el grado de acidez del agua, la composición química del suelo y su capacidad de ""amortiguación"" (buffering), así como de las características de los organismos vivos afectados.nLa deposición ácida contribuye a la reducción del pH en ecosistemas terrestres y acuáticos y permite la movilización de metales tóxicos, especialmente del aluminio. Esto ocasiona una variedad de efectos, como son daños a bosques y suelos, peces y otros seres vivos, materiales de construcción y a la salud humana. Asimismo, la lluvia ácida actúa reduciendo la visibilidad.nEn los bosques, la lluvia ácida produce daños al descomponer los nutrientes del suelo, dificultando el crecimiento natural de los árboles. El daño se puede extender a los pastos de las praderas, perjudicando al ganado, y a los lagos, pudiendo ocasionar la muerte de gran cantidad de peces.nLos efectos de la lluvia ácida en el suelo pueden verse incrementados en bosques de zonas de alta montaña, donde la niebla contribuye a aportar cantidades importantes de los contaminantes ácidos.nLa lluvia ácida contribuye a la degradación de los materiales de construcción y artísticos (mal de piedra) y la corrosión metálica. Los monumentos y edificios son sensibles a la acción de la lluvia ácida. Muchas ruinas han desaparecido o están por de hacerlo, a causa de este factor.nEl daño que produce a las personas es principalmente indirecto, mediante el consumo de peces y agua potable contaminados por la lluvia ácida.n¿Cómo se puede reducir la lluvia ácida?nPara reducir la lluvia ácida es necesario disminuir la emisión de los compuestos químicos que dan origen a los ácidos, es decir, de los precursores de los ácidos, los cuales son principalmente el bióxido de azufre (SO2) y los óxidos de nitrógeno (monóxido de nitrógeno, NO, y bióxido de nitrógeno, NO2).nEn la actualidad se puede disminuir la formación de SO2 eliminando el azufre de los combustibles fósiles o atrapando los SOx antes que se emitan a la atmósfera, mediante reacciones químicas que los transforman en especies químicas menos reactivas. La utilización de convertidores catalíticos disminuye la formación de NO y NO2, puesto que reducen dichos óxidos a N2 y O2."
es_3D8YOU6S9GXWRHZ17CASO86KHWA6U8	Necesitaría saber el tipo de compuesto que es el material del experimento para saber de antemano la reacción que va a tener (por ejemplo si es una base, un ácido, etc. para saber si va a ser una reaccion de neutralización ácido-base por ej.)\nNecesitaría saber, además la concentración del disolvente para calcular la reaccion esperada. \nNecesitaría saber la cantidad de vinagre para asegurarme de que la reacción se va a dar durante las 24 horas y no se va a acabar el disolvente (en este caso el vinagre) con respecto al soluto (material)
es_3D8YOU6S9GXWRHZ17CASO86KIXA6UB	Cuanto vinagre se echara en los recipientes? \nCuantas veses se deberia enjuagar las muestras con agua? \nEl estado de las muestras; son liquidos, solidos?
es_3DBQWDE4Y8BNDNFE5SO1I70QG345NW	La informacion que no esta incluida es el tiempo para cada muestra, de 24 horas, igual para los 30 minutos, y ultimamente la diferencia.
es_3DBQWDE4Y8BNDNFE5SO1I70QLDT5NA	Densidad inicial  (Initial density)nDensidad final (Final density)nvolumen inicial (Initial volume)nvolumen final (Final volume)
es_3DEL4X4EL8YQR532I0G7R6PHCWZXYO	temperatura, volumen de vinagre y material de los recipientes
es_3DH6GAKTY02FW03HJI4SOR5SIPKYZT	Para poder replicar este experimento necesito saber el volumen de cada material, además saber la temperatura inicial y final de cada uno y finalmente probaría agregando otro material más de muestra como el vidrio.
es_3DHE4R9OCYOP4YF50598UGOH2F1G2B	Es necesario informar la temperatura en la que se mantuvieron las muestras; el tamaño de las muestras y el volumen de vinagre utilizado.
es_3DL65MZB8FS4I2BGR38Q6QCRRTECEA	Necesitaria el tamaño the cada uno de las muestras, not todos los materiales son iguales aunque pesen similarmente.  Necesitaria tambien el tiempo del dia en donde las muestras fueron colocadas con vinagre, creo que si fuece de noche or dia, habria una differencia entre las medidas pues puenden ser afectadas con la temperatura. Al igual, deberia de tambien saber la temporada en el que el experimento se llevo a cabo, differencia en tempestad puede hacer major cambio durante el experimento.
es_3DQQ64TANIYHTR6BH8O2CWIY193WPJ	cuanto vinagre hay que echar\ncuanto deben medir los recipientes\ndonde hay que dejar reposar las muestras
es_3DY4FPOOA31PQFML4QNVVPZZUFPVRT	Cuanta vinagre poner en cada recipiente.
es_3DY4FPOOA31PQFML4QNVVPZZWQIRV6	Necesitaría saber si las muestras deben estar sumergidas en la vinagre, o la cantidad de vinagre utilizada\nSería útil una mejor descripción de los objetos, ya que la cantidad de área superficial de los mismos puede afectar los resultados\nTipo de plastico utilizado
es_3DZQRBDBSNSHFLKFZ5HU24CCXAW3S7	Tipo y material del recipiente; balanza; cantidad de vinagre.
es_3E337GFOLBLLTK4YMO7SM4RFEJANGA	1. Cantidad de vinagre usado en cada muestra, n2. Temperaturas,n3. Pesos adicionales: a) de recipientes, b) de los materiales antes de ser enjuagados con agua destilada y puestos en reposo.
es_3E47SOBEYS9GY7D2NMYHR5AJMCOCI5	buen dia, tomando encuenta  de que el vinagre es una composicion quimica de tro de los acido pueda ocacionar reaccion entre lo materiales expuestos al experimento. 1) el vinagren en el marmol. como todos sabemosel marmo es la composion de rocas calizas, y como todos sabemos lo que sucede cuando tomamos una roca y le agregamos agua ella se va desintegrando. los mimo pasas con el marmol aunque hay que tener en cuenta la acides del vinagre. y la dureza del marmol por eso la perdida de masa no fue mayor, 2) con respecto a la rocas calizas como ya antes mencionaba una rosa es mas propesa a quese degaste por eso se nota en las muestra que la perdida des mayor a la de marmol. 3) en el caso de la mader ella asorbe el vinagre como todos sabes y la masa aumenta pero cuando se deja reposar ella vuelve a su masa inicial ya que se seca por lo cual no hay diferencia entre la masa inicial y la final. 4) el pratico mundialmente usado como almacenados de toda materia en estado liquido tambien sufri un pequeño e insgnificante desgaste producto del tiempoq ue actuo en acido del viandro dentro de recipiente. espero que le haya parecido bien mi opinicion y espero que califiquen positivo.
es_3E47SOBEYS9GY7D2NMYHR5AJNK9CI7	1. Cuanto vinagre debe ser usado.\n2. El tamaño de los contenedores\n3. La concentración de agua destilada que se debe utilizar
es_3EF8EXOTT38S6FNAP7UXMA6SWM11JG	Necesitaba saber:\n- la temperatura del agua destilada\n- la temperatura ambiente durante las 24 horas\n- si los recipientes estaban cerrados o abiertos.
es_3EJJQNKU9TIK8ER1Z16RGO8QJDIHRG	necesitaremos explicar cuales son los resultados y cuales ingredientes nesecitamos
es_3EJJQNKU9TIK8ER1Z16RGO8QRMBHRZ	al notar que cada material fue colocado en el recipiente la masa tuvo reaccion de diferencia, pero entre los varos tipos la madera resalto ya que no hubo alteracion de masa y logro tener su gran diferencia
es_3EJPLAJKEOTDDGTBDZ9050LZSKDZ6Z	necesitaría saber el tamaño del recipiente, el material del recipiente y si el vinagre cubre totalmente a la muestra(es decir, si esta sumergido o no)
es_3EO896NRAY8TFZZJRQE7SGPNTDPTJZ	caliza
es_3ERMJ6L4D05WI98XHKOY3CPM2PLM70	Se puede repetir el experimento utilizando los mismos materiales pero a temperaturas diferentes (ej. en un frigorífico, en el sol, etc.).\n\nSe puede repetir con los mismos materiales pero con distintos ácidos (ej. ácidos cítricos, agua con gas, etc.) \n\nSe puede repetir el experimento también manteniendo el mismo ácido pero utilizando materiales diferentes (ej. hierro, hueso, carne-para introducir materiales bioloógicas en vez de materiales físicos, etc.).
es_3ERMJ6L4D05WI98XHKOY3CPMA8L7MV	¿Cuánto vinagre se necesita?
es_3EWIJTFFVQKKOAG0FNF6BPAQMQ2E0G	no se
es_3F0BG9B9MR0WCQXB0NC9X7CT8V77Y8	Necesito saber la temperatura de los materiasles, cuanto agua destilada se uso y que nivel de pureza tenia y que cantidad de vinagre se uso
es_3F6HPJW4JFDL1K55FADQGJA5PYZ2WN	1. Cuanto vinagre se necesita para cada muestra\n2. Material donde se secan las muestras \n3. Cuanto tiene que pesar cada muestra
es_3FE2ERCCZZL9OIX9QMXSV25CUHMPOY	1- Cantidad de vinagre (puede afectar la reacción química). 2 - Temperatura (puede afectar el tiempo de secado). 3 - Sensibilidad del instrumento que se usó para medir la masa (puede afectar el resultado final del experimento). 4 - Tipo de recipiente donde se guardó las muestras por 24 horas (el aire, la luz, etc. pueden afectar la reacción química)
es_3FE2ERCCZZL9OIX9QMXSV25CYCKOPP	cantidad de vinagre que se agrego a cada muestra, pesar los recipientes, a que temperatura se dejaron reposar las muestras.
es_3FE7TXL1LK0GHN9J31EKOUSJYAP2QD	De qué son las muestras, cuánto vinagre hay que echar, cómo realizar el pesaje
es_3FE7TXL1LK0GHN9J31EKOUSJZFD2QC	Creo que se pueden mejorar un poco las tablas con imagen de mas calidad para los lectores .
es_3FIJLY1B6WHFI5KGRJE288WY5EGPFW	- La cantidad de vinagre en cada recipiente. Dice que los recipientes son idénticos pero no la cantidad de vinagre en cada uno.\n- Diferencia de los resultados si las muestras no son enjuagadas con agua destilada.\n- La superficie en la que las muestras reposando. Hay diferencia si las muestras están en alguna superficie absorbente.
es_3FTF2T8WLTVW14Q40JS5Q6IJTY39W2	la informacion adicional requerida seria la cantidad de vinagre que echaron a las muestras y un grupo control.
es_3FTYUGLFSWYERBO1GYAYM2OW08JD5J	Necesitaría saber los siguientes datos adicionales:\n- Que tipo de vinagre fue utilizado. (Ya que existen distintos tipos de vinagre, como el de cidra de manzana, de jerez, etc).\n- De que material son los recipientes.\n- El volumen de los recipientes y si debe permanecer abierto o cerrado durante el proceso.
es_3G5W44VEU9VKLEJVPBFCUCABASGKGB	Cuanto vinagre?\nQue son las muestras?\nQue tipo de recipiente?
es_3G5W44VEU9VKLEJVPBFCUCABE9UKGR	SEGÚN ESTA MESA, EL DIFERENTE ALTO VALOR DE LA MISA FINAL ES PLÁSTICO. SU VALOR ES 0 Y LO MENOS DE VALOR ES CALIZA ES -0.01. ASÍ QUE LA CONCLUSIÓN DE ESTA MESA ES PLÁSTICO ES MUY MALA DE TODO EL MUNDO ECO. TAN PLÁSTICO ES MUY MALO METERIAL.
es_3GDTJDAPVWO0INDGRPG4HCLHBN98MH	Durante el experimento en los datos observe que Madera tiene muchas mas eficiencia que los otros incluyendo Marmol.
es_3GGAI1SQEXB2UQ3T81W9JYH07VOCMP	Que es ek material que ponemos con los muestros y porque usamos eso material en particular?\nQue hace el material a los muestros? \nPorque cambia la masa de cada muestra?
es_3GLB5JMZFZ8C78DLXUTPQZFLUMCGDX	Con los datos dados es mas que suficiente para saber la masa final y hacer la calculacion.
es_3GS6S824SSAHQ6UY1TBA87D33M1WN8	1.) Necesito saber que cantidad de vinagre se me hecha a cada masa. \n2.) Que tamaño o cantidad de masa/material se debe usar?\n3.) Cuanto tiempo se debe dejar reposar despues de enjuagar con agua destilada?
es_3GU1KF0O4KEP5O80MHS6PI5DOOBPBF	¿Los recipientes deben permanecer cerrados o abiertos durante las 24 horas? ¿las muestras se dejan reposar y secar de nuevo en el recipiente o en otro lugar? ¿hay que tener en cuenta alguna condición sobre temperatura ambiente?
es_3HMIGG0U4NJ0C42UAS4FB78OKHV8YJ	de que material sera el recipiente? \nen que pesar las masas
es_3HMVI3QICL5I14I9B7V0WXLGAZQY16	DE ACUERDO A ESTA TABLA LOS RESULTADOS DE FORUMUESTRA DEBEN SER MARMOL, CALIZA MADERA Y PLÁSTICO EN ESTA MADERA ES EL NIVEL MÁS ALTO DE MASAS DIFERENTES DE 0.00 Y EL NIVEL MÁS BAJO DE CALIZA ES -1.3 SOY MARMOL ES -0.4 Y PLASIC ES -0.01
es_3HRMW88U183I0Y8DWL3POXFZU9OM05	MADERA
es_3HUTX6F6VW0DWBW3OOMGZPXJK6T2OM	a) Cual es el objetivo del experimento\nb) Utilizaria diferentes soluciones acidas\nc) Mas muestras de control variando diferentes objetos que sean mas susceptibles o no a los acidos
es_3HWRJOOET7FKPJ0COPYQLVG9EXZSEM	volumen inicial del objeto, volumen final del objeto, densidad inicial del objeto, densidad final del objeto, diferencia de densidades.
es_3HYA4D452TWJQYJAPL3QCVO5VVFF29	Cantidad de Vinagre Utilizado\nIndicar si el vinagre es comercial o si es ácido acético ( de ser así indicar su concentración)\nIndicar si secan al medio ambiente o en un horno secador.\nIndicar el material del recipiente
es_3I7DHKZYGPDBPV2X745OA2RHEP45F1	1. Cantidad de vinagre a colocar en cada recipiente. 2. Tipo de vinagre. 3. Tipo de recipiente donde se colocará cada material.
es_3IAEQB9FMGX84U3LCZX7C219OTOWD0	El tamano de la pieza, que tipo de material y que cantidad de vinagre se debe colocar?,
es_3IGI0VL649X9LXLWA7K0RD0HVWWNO0	Necesitaria Typo o marka de vinagre, Objeto utilizado para cada material, y cuanto exposicion a la luz.
es_3IHR8NYAM9E5KPNR72IJH4Z7GT9P4K	cuanto es la cantidad de vinagre.de que material estan echos los recipientes,cual es la cantidad de agua destilada, como fue secado el material.
es_3ITXP059PYWS0ZM42Q9HIBT1IA2JSE	1) Que tanto vinagre necesito agregar en cada experimento? 2) Con cuanta agua necesito lavar la muestras, cualquier cantidad? 3) Mientras espero los 30 minutos para que s sequen, debo dejarlas en que temperatura? al aire o encerrados?
es_3IX2EGZR7DWGZKMRN19CS1O53IFJRD	Cantidad de vinagre utilizada en cada muestra. El tipo exacto de vinagre, o la acidez del mismo. Las condiciones externas (temperatura, presion atmosferica). Cantidad de superficie de las muestras, o su geometria.
es_3IXEICO794WHR4KC77KIJCKIYJ46TK	El tamaño del envase y el material del que esta hecho y la cantidad de vinagre usado.
es_3J2UYBXQQNPGBVNL95W8Z1ID174603	Necesitaría saber cuánto vinagre agregar a cada muestra, también si la cantidad de vinagre debe ser relativa a la masa de la muestra al comienzo del experimento. También es necesario saber cuál es el objetivo del experimento para poder utilizar los resultados para sacar conclusiones, es probable que se realicen cálculos. La temperatura también puede ser importante en los experimentos, necesitaría saber la temperatura a la que se realizó el experimento original para replicar los resultados correctamente.
es_3J88R45B2IBWIRB1RDKOEFW5D0NXP8	necesitaría saber la cantidad de vinagre para añadir en el recipiente en el procedimiento 2. necesitaría saber si el recipiente se debe cerrar o dejar abierto y finalmente necesitaría saber exactamente el tipo de material, que tipo de plastico, que tipo de madera para replicar el experimento
es_3JBT3HLQFAFLNMBGSV89B0CGEI5ZPK	Saber la cantidad de vinagre que se les coloco, saber si todos los materiales estaban completamente cubiertos por el vinagre y saber cómo se secaron los materiales(si fue al aire libre o si se secó con un secador de pelo)
es_3JBT3HLQFAFLNMBGSV89B0CGLP3PZT	1. De qué tamaño eran los recipientes.n2. Cuánto vinagre se usó por recipiente.n3. Si todas las muestras tenían la misma superficie.
es_3JCG6DTRV53X96B45C4LKCQMFIJQQ0	Tipo de mustras utilizadas, concentration de vinagre y su tipo.
es_3JCG6DTRV53X96B45C4LKCQMN95QQC	Para poder replicar el experimento, primero necesito saber la cantidad de vinagre que echaron en cada recipiente. Segundo, necesito saber el tamaño y la forma de los contenedores que usaron. Tambien necesitaria saber la cantidad y temperatura de la agua destilada que utilizaron para enjuagar cada muestra. No estoy segura si alguno de los factores anteriormente mencionados tendrían algún efecto en los resultados.
es_3JNQLM5FT6Z5QQT6BW6O78TPPXGL28	Agua
es_3K3R2QNK8DGJ901Z5JD48IXM9ZAU95	Para poder replicar el experimento necesitaria:\n1º Saber la temperatura de la habitación puesto que afecta a los procesos de reacción química. \n2º Saber la masa de Vinagre que han añadido o al menos saber si han cubierto las muestras completamente o no (no lo deja claro)\n3º Las descripciones de las muestras son vagas, una simple palabra, para poder replicarlo necesitaria saber que tipo de plastico es y que tipo de madera es. En cuanto al marmol y a la caliza creo que si son un material unico y determinado.
es_3KGTPGBS6ZY89GG0KAYPYVP83C62UT	Caliza
es_3KJYX6QCMBO8SR38WLEMTYD8IIXJVT	Falta información sobre el volumen de vinagre para analizar cuánto reaccionó con los materiales seleccionados.
es_3KKG4CDWKKBKS27KQDMMVEZS9KK94Q	fue una experiencia unica ver como se determina una masa cuando esta en vinagre
es_3KOPY89HMAFOGI1PCB8GA3LPRSRJ37	Caliza
es_3KV0LJBBH4Y60SSCQYM48TGM79JMRN	La lista de cosas necesitadas al principio incluyendo de donde se pueden conseguir y los tamanos. Que es el proposito del experimento, que hacer con los resultados, la significancia de los resultados y como aplicarlos a la vida ordinaria o projectos o trabajos
es_3L2IS5HSFCV4Y25T6TW9QJS6JCYUNS	DE ACUERDO A ESTA TABLA CUATRO LISTA DE MARCOS DE ESTUDIANTES DEBAJO DE ESTA ES A, B, C, D. EL B HISTORIA DE PUNTOS MÁS ALTO DEL CRÉDITO DEL ESTUDIANTE B Y EL PUNTO DE PUNTO DE CRÉDITO Y CADA ESTUDIANTE TIENE UN PUNTUACIÓN MEDIA DE C y D. EL ESTUDIO CONTIENE UN USO PLÁSTICO Y EL MANTENIMIENTO DEL RESULTADO.
es_3L2IS5HSFCV4Y25T6TW9QJS6KCXUNS	Se necesitaria la cantidad de vinagre en cada recipiente. Tamaño de muestra. La cantidad de agua que se uso para enjuagar, para que sea la misma para cada una. La pesa usada para encontrar la masa. Por ultimo saber donde se puso a secar?
es_3L6L49WXW2A1RF58NN95JYUQMPJ45D	Se necesitaría saber:\nLa cantidad de vinagre utilizado\nEl tipo de vinagre utilizado\nEl tipo de recipiente utilizado\nTiempo y forma en que se enjuagó la muestra
es_3L6L49WXW2A1RF58NN95JYUQWOT54W	1) Cuanto vinagre echan a cada recipiente.n2) Que tipo de vinagre echan.n3) Tamaño de los recipientes.
es_3L70J4KAZIZBXH0IBU1FUD4IX5ZDAB	ESTAS COMPARADAS CON LOS PRODUCTOS ES MAYOR QUE LA MADERA
es_3LKC68YZ3CGZ8RUA28BNNWD8OJOWOA	Necesitaria masa, 4 recipientes, VInagre y Agua Destilada para poder duplicar el experimento.
es_3LKC68YZ3CGZ8RUA28BNNWD8OKEWO2	Si se guardan en luz u oscuridad.\nTemperatura del ambiente en la que se guardan.\nMaterial del recipiente en el que se guardan
es_3LPW2N6LKVF08DZN2T0NW2SKMJMU54	¿Qué pH tiene el vinagre?\n¿Qué tipo de balanza se utilizó?\n¿cuánta agua destilada se utilizó?
es_3LQ8PUHQFN57FFOI9ECI2W7Z3WJIHY	Despues de las 24 horas es la misma cosa, dejar secar  las , repetir cada uno.
es_3LRLIPTPESMJBN6S3BN2YQZ8KDFKAF	cantidad de vinagre utilizada, cantidad de agua destilada utilizada para enjuagar y como se ha llevado a cabo el proceso de enjuagado y secado, forma de las muestras de material y composición específica de cada material
es_3LRLIPTPESMJBN6S3BN2YQZ8L2CKAR	Para replicar el experimento necesitaría saber las condiciones del sitio donde se almacenaron las muestras, la cantidad de vinagre que fue utilizada, que tipo de peso fue utilizado y bajo que parámetros escogieron esas muestras.
es_3LUY3GC631D23C5A90GQKGJHDNWP7R	Ocuparias las misma cosas que  fueron usados para la muestra.. Tambien ocuparias la cantidad de vinagre que usaste. Y tambien ocuparias quitar las muestras al mismo tiempo que a las que se hicieron en la primera prueba.
es_3LWJHTCVCEZ0IHLVRWTR8DM88TCQFY	Para replicar el procedimiento, necesitaria 4 mas recipientes nuevas y limpias y 4 mas muestras identicas al las usadas en el procedimiento. Tambien necesitaria saber cuanto vinagre fue echado en las muestras en el primer procedimiento para que saberia cuanto echar. Tal vez, despues del inicial procedimiento y determinando los cambios en las masa de cada muestra, continuaria observar como cambian las muestras por determinando la masa tres veces mas en intervales de 30 minutos.
es_3M0NZ3JDP3BHUCTX8GZVDU7ZVJRZ5V	marmol
es_3M1CVSFP62I5MQ4NGG7ZUCBHK9QAQX	Cuanto vinagre hay que echarnDonde se guardan las muestras durante las 24 horas, temperatura al aire libre o cerrado.nTamaño de los recipientesnMaterial del que esta hecho el recipiente
es_3M23Y66PO4KGC47XI7FS97OWYMM6S1	cuanto vinagre?\nCual es la temperatura del cuarto durante los 24 horas?\nCual es la hemdad relativa en el cuarto durante los 24 horas?
es_3M68NM076JK4BP7K3IFNJXJ0HJX6RA	Necesitaria saber la temperatura del aire ambiente y la humididad.
es_3MAOD8E57SNWF6ZOBY7WAQRAD13XNP	1. Se necesita saber el tipo de recipiente recomendado ya que diferentes tipos de recipientes podrían variar las masas finales resultates.\n2. Sería recomendable estandarizar la masa de las muestras iniciales para que exista una proporcionalidad en la diferencia entre masas.\n3. Se deberia utilizar al menos 3 decimales para la realización de mediciones ya que con masas tan pequeñas podrían generarse datos que se descartan por temas de redondeo.\n4. Es recomendable especificar el tipo de vinagre a utilizar ya que vinagres naturales o sintéticos podrían generar diferentes resultados.
es_3MRNMEIQW7JST0RM8LQ53RKTLW2DLL	"En principio me hace dudar la madera. Fue pretratada con algun quimico? Porque de no ser asi, deberia haber absorto mas liquido y por lo tanto incrementado su masa ya que esa una de las caractersticas de la madera. No creo que 30 minutos fuera lo suficiente para que la madera evapore el liquido y deberia haber visto mas diferencia. Por otra parte, hubiese sido mas interesante que hagan el experimento usando Muestras que tuvieran la mmsma masa inicial. De esta forma, es mas facil comparar los resultados. Por ultimo, es important limpiar las muestras ya que el uso del vinagre seguramente ""limpio"" las muestras de escombros y por eso hay diferencia luego de dejar secar."
es_3MX2NQ3YCB7SPHTI7YBAG9ROFOP5X2	Desearia saber que tipo de vinagre se uso, la cantidad que se uso en cada recipiente y que tan rapido el vinagre actuo en cada recipiente
es_3N1FSUEFL7DWVSK12TROHAII07G4DN	Especificar la cantidad exacta de vinagre necesario para cada muestra\nTemperatura a la que deben secar las muestras\nLugar y temperatura para el reposo de 24 de cada una de las muestras
es_3N8OEVH1FT3R3IL8BMKD620MMDGOOA	tipo de vinagre, concentracion del vinagre, cantidad del vinagre utilizado, temperatura a distintos puntos, repetir el experiment a distintas temperaturas
es_3NAPMVF0ZYS6B544725EO3BOTKV72I	no sabría responder.
es_3NC5L260MQZXX58FCJ1NJ8R8TBVFOI	Cantidad de vinagre a utilizar, tipo de vinagre, concentracion,
es_3NJM2BJS4YJ8FT060HO102BV93PPCR	DEterminar hasta que punto se llena el recipente con vinagre. Si la muestra puede se revisada sin disturbar el liquido e identificar porque algunos objetos perdieron mas masa que otros. Deido al material ?
es_3NKQQ8O390IVCQEGHZI6UEGCZJDDUQ	Madera
es_3NL0RFNU0H049YQBUADBLND8KAX4K8	¿Qué instrumento utilizo para determinar la masa? ¿De qué tipo de material deben ser los 4 recipientes? ¿Qué cantidad de vinagre se agrega? ¿Qué peso se sugiere para cada muestra?
es_3NOKK93PR3LJF0VUNUELWECUES2EES	Vas a necisitar mas plastico y caliza para hacer el experimento otra ves.
es_3NOKK93PR3LJF0VUNUELWECUM2QEE8	1. Cantidad de vinagre que se añadión2. Procedencia de las muestrasn3. Tipo de recipiente que se utilizón4. Condiciones en las que se mantuvo durante las 24 horas, (temperatura presión)
es_3NPI0JQDAQIP1A2HM3JRPCBZTNVPT8	Para replicar el experimento se necesitaría saber la composición química o marca (exacta) del vinagre utilizado, la cantidad de vinagre utilizada para cada muestra y la composición de cada uno de los materiales probados.
es_3NVC2EB65SCEB7WOYB9JKQ0DCXX3YS	La cantidad de vinagre que se ha puesto en cada muestra, el tipo de recipiente donde se puso el vinagre, ny la  medida de las muestras estos datos serian necesarios para poder replicar este procedimiento.
es_3O7L7BFSHG2VV5XGJD4CHTAM4Y5EIL	La cantidad de vinagre que necesito. La cantidad de agua destilada. Que tipo de recipientes.
es_3O7L7BFSHG2VV5XGJD4CHTAM509EIU	Cual es lo tipo de recipientes usados, la cantidad de vinagre y la cantidad de agua destilada.
es_3OJSZ2ATDU9YA2NRPL7CMAE0FOY75L	Equipo de seguridad a utilizar, tipo de recipiente, método de secado ideal
es_3OLQQLKKNU2RQGHM1VPCTUPMIL9EJT	Cual muestra puede sobrevivir mas en lluvias acidas. En este caso el caliza tiene el gran diferencia de -1.3 entonces no puede sobrevivir mucho tiempo si sigue estando en un clima acida. Marmol y plastico tambien se acaban en lluvia acida pero se derretirá lentamente. La madera es la unica muestra que no cambio y pueda vivir en esa clima.
es_3OONKJ5DKEW7KOWZ7HFR0I0NJWTBOT	índice de refracción del vinagre\ntemperatura constante\nGravedad del area\nHumedad
es_3OS4RQUCRBSDEBJ68EW1DOR9LROBFF	Para poder replicar el procedimiento, necesitaria saber exactamente que tipo de vinegra han utilizado. Que tipo de luz se encontraba, osea en donde estaban ubicados, ya que la luz y clima podrian afectar los resultados. La ultima cosa que necesitaria tambien para poder replicarlo es el tipo de muestra utilizado. Basicamente, de donde provienen las muestras, especialmente la madera y el plastico, ya que hay varios tipos de maderas y plasticos.
es_3OSWBBLG1GANTU8BM4TTELFGW5PDXO	Forma de las muestras (¿están en bloques, pulverizadas...?), tipo de plástico y de madera (hay múltiples plásticos y la madera puede ser de muchos árboles distintos), ¿Esán las muestras completamente sumergidas o flotan (al menos parcialmente)? y en relación con esta última pregunta: volumen y forma del recipiente
es_3OVR4I9USRWQK1O67FX8H9PHI1HQ4J	Necesitaria conseguir las 4 muestras\nNecesito saber la cantidad de vinagre que hay que echar en cada recipiente\nNecesito saber si la dejo secar al sol o en un lugar templado.
es_3OWEPKL08BP20RTXTL3YGREM58QN7G	Cantidad de vinagre utilizado, tipo de recipiente utilizado, si las muestras son una sola pieza de material o son varias piezas que suman el peso total de cada muestra. Si todas las muestras estan estado natural .
es_3P529IW9K0YPRK5IZRLVRRNEX7ULFC	Necesitariamos saber cuanto vinagre se echo en cada vaso. si los frazcos tenian el mismo vinagre, y cuales materiales se deshacen mas facil en agua
es_3P529IW9K0YPRK5IZRLVRRNEZHOFLM	Volumen de vinagre utilizado en cada muestra.\nTamaño (volumen) mínimo de los recipientes utilizados.\nListado de los diferentes materiales a utilizarse como muestra durante el experimento.
es_3PB5A5BD0XJWQZCB6HQ3Q75P3ZIG7K	Para replicar el experimento, las cosas más importantes que se deben entender son las cantidades de material requerido en cada experimento. ¿Cuánto vinagre se debe agregar a cada muestra? También sería mejor para el experimento si se usaran las mismas cantidades de cada muestra en todos los experimentos. La temperatura es importante en las reacciones químicas y, a menudo, determina la velocidad de la reacción y hasta qué punto se completa, por lo que es importante saber a qué temperatura se llevó a cabo el experimento original. También sería importante saber qué tipo de vinagre usar, no se especifica en el experimento, pero podría tener un fuerte efecto en los resultados si se cambia.
es_3PDJHANYK7TRMVTH7D3T5THUPX06HJ	Cuanto de vinegra se necesita, cuanto de agua se necesita, en que condiciones se dejaria secar las muestras
es_3PDJHANYK7TRMVTH7D3T5THURMWH66	que cantidad de vinagre se uso en cada recipiente\npor cuanto tiempo se tiene que enjuagar cada muestra con agua destilada\nque es el peso de cada recipiente sin la muestra
es_3PH3VY7DJNAB7V8H4HM43UKC7E2ZW7	Algo adicional y necesario para replicar el experimento es saber cuanto del vinagre usaron. Especificamente, cuanto litros de vinegre usaron para cada material, y si fue consistente. Otra dato necessario para replicar el experimento va hacer sabiendo la masa inicial del material principio, donde la muestras para el experimento estaban obtenido. Tambien necesitamos saber como eran los recipientes, de que eran hechos y donde estaban almacenaron. Finalmente, es neccessario saber si tenian un control para cada material, para asugarse que la masa inicial no es tan differente de la masa final sin el uso del vinagre.
es_3PM8NZGV80THI3CGRQZDEKMFIKZQXU	Necesitaria saber que cantidad de vinagre se le echo a cada muestra. Tambien seria util saber a que temperatura estaba el cuarto donde se realizo este experimento, y por cuanto tiempo se enjuago cada muestra.
es_3PQ8K71NHZXDZAX6RKAD4CWCH4TAA6	Necesito saber el tamaño de cada muestra, la cantidad de vinagre añadida a las muestras, el tamaño de los recipientes y la cantidad de agua utilizada para el enjuague. Con estos detalles creo que podria replicar el experimento.
es_3PQMUDRV7TJ7BAZ2FWU3288E62AIIS	Tipo de vinagrenMaterial del recipientenCondiciones de almacenamiento de los recipientes
es_3PS7W85Z81F49NMA5ENU3MBKQ3XT97	¿Cuál es la concentración o tipo de vinagre utilizado?\n¿Cuál es la capacidad de los recipientes?\n¿Qué cantidad de vinagre se ha vertido en los recipientes?\n¿Bajo que condiciones atmosféricas se ha realizado el experimento (temperatura, humedad, presión atmosférica)?
es_3PS7W85Z81F49NMA5ENU3MBKWB2T9Y	No entiendo bien la pregunta. 1. Pudiamos dar mas datos acerca de que clase de equipo se necesita. 2. La madera es natural y no cambia de masa. 3. Caliza cambio a al majoria.
es_3PWWM24LHUBABJ9NH7XK237J4ZX82S	CON QUE HERRAMIENTA MANIPULAR LAS MUESTRAS?\nCUANTO VINAGRE DEBO USAR POR RECIPIENTE?\nDEBO DE SECAR LAS MUESTRAS BAJO EL SOL O A TEMPERATURA AMBIENTE DURANTE LA NOCHE O LUGAR VENTILADO?\nCON QUE FORMULA PUEDO ENCONTAR LA MASA DE LA MUESTRA?
es_3PWWM24LHUBABJ9NH7XK237JD8882U	Cantidad de vinagre, tiempo de reposo de las muestras en vinagre, tiempo de secar.
es_3PZDLQMM0VYCNMZ0YJDP4P32U7V2C3	No se
es_3QECW5O0KJEL80KY2OADR66I2LZ5T3	se necesita saber la cantidad del vinagre, la cantidad del agua destilada y la capacitad de absorber los liquidos de las muestras.
es_3QECW5O0KJEL80KY2OADR66I5SCT5L	bueno nesessita los ingridientes escrito de ariba. tanbien las instrusiones.
es_3QECW5O0KJEL80KY2OADR66IAC3T5L	Altitud, Temperatura durante 24 horas, Temperatura de secado
es_3QFUFYSY90STTCYXTZME5AL3BOZ4F8	Los estudiantes necesitan añadir el nombre de cada muestra, el tamaño de cada materia y la cantidad de vinagre que hay que añadir en cada recipiente. (The students need to include the name of each material, the size of each material and the amount of vinegar to be added to the container.)
es_3QILPRALQ78605YG3QV4URAHO1D8NV	Masa Inicial, MasaFinal y la differencia entre Masas
es_3QIYRE09Y5UOP5EV45MPFHN96KLN1E	Informacion addicional que se podria ocupar seria cuanto fue el volumen de vinagre que se hecho, cuanto tiempo se estuvieron enjuagando, y si estaban las muestras cubiertas completamente por el vinagre o no.
es_3QRYMNZ7F0UPYPQ46O6ZLN643LSTNE	No se
es_3QUO65DNQW1MGN5578WM58SB6HAOUV	Resultado final, imagen con la demostracion y los datos
es_3QUO65DNQW1MGN5578WM58SBBZ2UOY	balanza de precisión, calculadora, pinzas
es_3QUO65DNQW1MGN5578WM58SBD0OUOO	Primera mente se necesitaria duplicar el procedimiento exacto con el mismo material y la misma cantidad de vinagra para ahi poder verificar los resultados que se obtengan.  Una vez replicado se puede comparar entre los dos resultados y  concluir con el promedio de  diferencia entre las masas.
es_3QXNC7EIPK83TEPJ7CZKJB9FR7F099	¿Cuanto vinagre agregar a cada recipiente? ¿que instrumento se uso para medir la masa? ¿a que temperatura estaban los distintos materiales?
es_3QXNC7EIPK83TEPJ7CZKJB9FR9T09R	Creo que necesitaria el tiempo en el que se conducira el experiemento. Los resultados pueden ser afectados dependiendo si es noche o dia cuando el experimento se lleva a cabo. Tambien necesitaria la temperatura del cuarto en donde se llevo a cabo el procedimiento. Necesitaria saber el tipo de cada material, porque cada material tiene variaz versiones. Por ejempo, el plastico, al plastico de vaso y al plastico de  contenedor, los dos son plasticos pero tienen differente estructuras.
es_3R9WASFE21T9W9MMESC4Z6YCCDJFZ0	Volumen de vinagre a poner en cada recipiente. Tipo de vinagre a utilizar. Temperatura a la que se lleva a cabo el experimento. Hacer inicialmente una lista de materiales a utilizar en el experimento.
es_3RANCT1ZVHU2XTGW33R0ZOSCZSWBU3	Temperatura del agua y del ambiente, saber si los recipientes estaban cerrados o no, saber el tipo de vinagre que se utilizó y su ph.
es_3RRCEFRB7OP3GVMHOX0IMKUIWLZ4B8	¿De qué material son los recipientes? ¿Dónde dejamos secar la muestra? ¿Qué necesitamos para determinar la masa?
es_3RRCEFRB7OP3GVMHOX0IMKUIXNZB4K	cantidad de vinagre a utilizar, cantidad de agua destilada a utilizar, ¿se utiliza algún artefacto para secar las muestras?
es_3S06PH7KSTHF3TNIFB8MJCBFNUQ1D4	nivel de vinagre (si el material tiene que ser completamente cubierto), temperatura, tipo de vinagre, y para mi el peso inicial tiene que ser el mismo
es_3S06PH7KSTHF3TNIFB8MJCBFSLF1DG	Que clase de vinagre se necesita usar. Y cuanta cantidad de agua destilada se puede utilizar. En que lugar y temperatura se guarda las muestras por 24 horas. Y donde se dejan las muestras reposar y secar durante 30 minutos.
es_3S96KQ6I9OHGCDZRHUSWPIUAJVSDT4	1) el tiempo debe ser necesario.\n2) espacio de fórmula\n3) masa media
es_3S96KQ6I9OHGCDZRHUSWPIUAKEETD9	1. Que tipo de vinagre se utilizaría; ácido acético o algún otro compuesto?\n2. Cantidad de vinagre a utilizar en cada muestra\n3. Tipo de lavado final, solo con agua destilada? algún implemento para restregar adicional?
es_3SB4CE2TJX8PVN5Z2U2ROK7ABHKAX5	En la reacción, la parafina de la vela se combina con oxígeno para dar lugar a dióxido de carbono y agua (y alguna otra cosa como carbón elemental o “carbonilla” que podemos olvidar. Para que la reacción quede ajustada, la parafina ha de aportar carbón e hidrógeno en la misma proporción que el metano (ver figura). La explicación clásica se fija en el lado izquierdo de esta reacción para decir que el oxígeno va desapareciendo a medida que se produce la reacción, hasta que se agota y solo queda nitrógeno (4/5 de la cantidad original, por la composición del aire).
es_3SB5N7Y3O5HI8OCRLI5UBSV2XHY0GK	Algunos datos podrían ser: temperatura, cantidad de vinagre (ml) y estado o tipo de muestra.
es_3SITXWYCNXMUEXAR882NJVRGPLDBXD	Se concluye que: La masa Caliza es mas propensa a modificar su masa, cuando se le altera por medio de vinagre, y la masa Madera es mas estable, no sufriendo modificación alguna cuando es expuesta junto al vinagre. Considero que este experimento estaría más completo, si además del vinagre, se utiliza otro líquido como la leche, o aceite. Saludos.
es_3SLE99ER0PQJJSA69QQ8GG7R450BZA	QUIERO MÁS INFORMACIÓN EN ESTE PALÁSTICO Y SUS USOS Y SU MUY MALO DE NUESTRO MUNDO Y SU REALIZACIÓN DE NUESTRO MÉTODO QUÍMICO Y MÁS DE CALIZA.
es_3SNLUL3WO60EA228UGGUDROH830LUL	el experimento esta muy bien elaborado y no necesitaria informacion adicional para responderlo, otra información adicional me parece que seria a nivel de informacion\nejemplificando tres serian:\n1. dimensiones de cada material (deberian ser iguales).\n2. ph de cada material.\n3. concentracion del vinagre.
es_3SUWZRL0M0QF2L2FHCVNKQKH5U16EU	la cantidad de vinagre para cada recipientenrepetir otra prueba para validar los resultadosnel tiempo de secado debe ser mayor ya que hay materiales como la madera que puede tardar mas en secar
es_3TE3O85732LGTOOJGG3KTK2OY9NR2T	dado que los atomos son invisibles en una molecula debe de haber un numero entero y deben saber cual es la masa de la muestra en gramos
es_3TEM0PF1Q7AFW420JS4M57S5S6K0DI	1- Especificar el material de las muestras. n2- La medida de cuanto vinagre se tiene que echar.n3- Como exactamente remover las muestras del vinagre.
es_3TK8OJTYM3Y4E266RYJ6QUZKTKHPVL	Para poder replicar el experimento se tendria que conocer:\n1. El tamaño y material del recipiente utilizado.\n2. Especificar la cantidad de vinagre a añadir a cada recipiente y si cubre la muestra en su totalidad.\n3. Detallar el proceso de secado, a que temperatura se dejan secar las muestras.
es_3TR2532VIR7ND1O7VD6EH6X92U2J69	mas tiempo?
es_3TVSS0C0E3DFLJZIYPXMH6JVOKDWTR	primero comenzaria por incluir un control de una muestra sin vinagre para ver si depronto la muestra pierde masa sin exponerse al vinagre. segundo realizar los experimentos mas que una vez depronto no siempre se affecta la exacta perdida de masa y tercero la cantidad de vinagre usada. Tambien no usar agua destilada talvez el agua puede affectar las muestras.
es_3TXMY6UCAG1TF51L0U3Q0715E1EQCQ	El marmol, la caliza y el plastico.
es_3U0SRXB7CFICIADC2Z14L85M6UBRNU	necesario saber si los materiales solamente pueden ser inorganicos o tambien organicos\nNecesario saber las condiciones de temperatura y humedad durante el tiempo de secado
es_3U5JL4WY5MMATYPITTS0BHLAGO94X4	cantidad de vinagre (ml), cantidad de agua destilada (ml), tipo de recipiente
es_3U5JL4WY5MMATYPITTS0BHLAOHBX4T	Que tipo de recipiente se usa? Que tipo de vinagre se usa? Donde se dejan las muestras, adentro, afuera, en caliente, frio?
es_3U5NZHP4LTFZW1BMM922BT8BNY5HPA	1. Tipo de vinagre\n2. Cantidad de vinagre\n3. El procedimiento de enjuague con agua destilada (tiempo, cantidad, numero de repeticiones..)
es_3U8YCDAGXRT9LD65OEA656Z4A02Q0Z	Que efecto tiene el vinagre en cada muestra?nPor que el vinagre tiene tal efecto en piedra?nPor que la madera no tiene efecto cuando esta metido en el vinagre.
es_3UJ1CZ6IZJ2KT07JDO5NH1AWAJG5SH	¿el tipo de vinagre usado hace diferencia?n¿Cuál es la cantidad de vinagre que se utiliza en cada muestra?n¿los recipientes deben ser de vidrio, obligatoriamente?n¿al reposar las muestras las mismas deben quedar cubiertas o expuestas?
es_3UJ1CZ6IZJ2KT07JDO5NH1AWBA0S57	1. Como es el aspecto fisico de la muestra?n2. No lavar las muestras despues de 24 horas..yn3. Pesar inmediatamente despues de 24 horas.  W = m/V
es_3UNH76FOCUIFXT4Y4TEYGP9J6TYMYF	Volumen de vinagre inicial.\nVolumen de vinagre final.\nTiempo de enjuagado en agua destilada, o volumen de agua destilada empleado para el enjuague.\nVolumen inicial de cada muestra (11.2 g de madera pueden ocupar más volumen que 9.8 g de mármol, y por tanto tener menos superficie expuesta al contacto con el vinagre si no queda completamente sumergida)
es_3UNH76FOCUIFXT4Y4TEYGP9J84BYMS	Necesito lo mismo cuatros muestras diferentes y necesito saber cuanto vinagre que yo necesito echar en cada recipiente.
es_3URFVVM167VYFRJC9H73L6ZFV69ZUF	"Adicionar as seguintes informações para melhorar as orientações e informações:nn- Deixar as amostras no mesmo ambiente durante todo o experiento, evitando locais refrigerados ou com iluminação solar, assim evitando maiores ocilacoes de tempeturaturas e interferências nos resultados.nn- Criar uma tabela com as colunas de ""Nome da Amostra"", ""Masa Inicial (g)"", ""Masa Final (g)"", ""Diferença entre masas (g)"" e preencher as linhas com as informações colhidas."
es_3UXUOQ9OKGAVG8Z8KHYTULUM52A7A0	Necesitaria saber la cantidad de vinagre que echaron en cada recipiente, el tipo de vinagre y que tan rapido se disminua la masa de cada recipiente
es_3VD82FOHKS1QUTO5LHBMB265VVWOC2	Tiempo, nivel de vinagre, material
es_3VELCLL3GMWC1D1E6H3C7CE06FA1F6	Tipo de recipiente, si las muestras fueron probadas al mismo tiempo y la forma de las muestras
es_3VFJCI1K41C68IWQFVO9VOWPCBORGE	- Cual seria el peso inicialn- La cantidad de vinagren- El tipo de material del recipiente que las muestras se quedaran
es_3VHP9MDGRPXWOGBCMESWO8XR5WRCFW	Para cada procedimiento se puede observar la cantidad de tiempo adquirido y el resultado de cada experimento consiste en resultados diferentes, con más consistencia o no.
es_3VNXK88KKEVJMFQZA9N944Z5WX2V95	Para explicar mejor el experimento, primero debemos pesar la masa del vinagre (datos adicionales 1) y después del experimento (datos adicionales 2). Para verificar que la masa perdida por las diversas muestras se haya disuelto dentro del vinagre (masa adquirida del vinagre, datos adicionales 3).
es_3VSOLARPKDMZA6OGQZH3L97MUII39O	No se entiende muy bien cuál es el propósito del experimento. Si no entiendo mal, se intenta simular el efecto de la lluvia ácida sobre distintos materiales utilizando vinagre. Las muestran se pesan inicialmente, luego se sumergen en vinagre para simular la erosión, y finalmente medimos las masas para ver qué cantidad del material se perdió.\nPara reproducir el experimento, creo que haría falta saber algo más sobre los recipientes con vinagre. Habría que especificar el tamaño de los mismos y la cantidad de vinagre a utilizar (al menos aproximado), o la proporción con la muestra a utilizar. Habría que saber qué tipo de vinagre se usa, es decir indicar su densidad con precisión. La densidad de los materiales también es dato útil. Esto es importante ya que si la densidad del vinagre es menor que la de las muestras, éstas se irán al fondo del recipiente. A su vez, la profundidad del recipiente afecta en la presión que sufren las muestras si se hunden. Esto puede influir en la erosión que sufren.\nTambién es importante saber la temperatura inicial del baño de vinagre. Si no se especifica, se entiende que es a temperatura ambiente, o temperatura estándar, es decir 25 grados C.\nQuizás sería importante calcular la masa relativa perdida por cada muestra, es decir la razón entre su masa final y la inicial. Sobre todo porque las muestras no tienen todas la misma masa inicial.
es_3W92K5RLWWU0LSON7JASSOU366G5VR	Cuanto vinagre echar, cuanto miden los recipientes, cómo determinar la masa
es_3WJ1OXY92CTZGM4RUMQZ8LQHJY7A88	Datos extra: a. Temperatura en los recipientes durante las 24 horas.\nb. Tipo especifico de cada material. Ejemplo, tipo de plástico, de madera, etc.\nc. Cantidad de vinagre utilizado.
es_3WOKGM4L73T601TP91I2G144P2P0O6	Para tener un resultado más robusto, és necessario replicar, tener en el minimo 3 pruebas de cada.
es_3WR9XG3T65OGEJJRBGO2HI8MK0W74U	1. Que tipo de recipiente fue utilizado. 2. Que tipo de vinagre fue utilizado. 3. Número total de muestras utilizadas.
es_3WR9XG3T65OGEJJRBGO2HI8MLXF748	Dejar uno sin nada para ver las deferncias. nMuestra: VideronMuestra: Metal
es_3WS1NTTKE0PCUOGWAYZCT7VQ1350FZ	Cantidad de vinagre usada en cada experimento.
es_3WS1NTTKE0PCUOGWAYZCT7VQ2AN0FW	PLANCHAR, ALUMINIO, FIBRA
es_3WSELTNVR5FIE6WFXK1UZHM42Y3TA6	Pienso que la información que podría incluirse  para hacer más preciso el experimento son el volumen inicial del contenedor donde se coloca el vinagre con cada material, el volumen final después del tiempo utilizado y la diferencia total. También el cambio de pH(acidez)del vinagre/ materiales antes y después del experimento. Por último, determinar si el experimento se llevó a cabo a nivel del mar( como una costante que afecta el experimento) o a una mayor altura que afecte el valor de la gravedad y por lo tanto el valor del peso (gr).
es_3WYP994K194D8QJ6HD7HRTCXMBOY6S	El enfriamiento por evaporación es distinto de los sistemas de aire acondicionado típicos que utilizan ciclos de refrigeración por compresión del vapor o absorción. El principio de funcionamiento del enfriamiento por evaporación se basa en emplear la gran entalpía de vaporización del agua, dependiendo de la superficie en donde se posa.
es_3WYP994K194D8QJ6HD7HRTCXNH76YW	madera, 0.0; caliza, -1.3; màrmol, -0.4.
es_3WZ36BJEV5TNXG173Y1QUS6ACHPTBW	Es necesario saber si las muestras solamente son de materiales inorgánicos o tambien pueden ser orgánicos. El resto de instrucciones estan claras y es facil de replicar el experiemento
es_3X08E93BHXVBP690BUCP82S4EPN66V	El tamaño de los recipientes, la cantidad de vinagre que había en los mismos y si los recipientes estaban cerrados o no.
es_3X0H8UUIT31E6JM39PSW71N9L8QSW2	Necesito saber los límites de error utilizados al medir las masas. Necesito saber la composición química exacta de las diferentes muestras. Necesito saber si hubo algún error humano involucrado.
es_3X4MXAO0BI1254MQU0SRHRID2UTRWE	La cantidad de vinagre en cada muestra, la masa inicial de las muestras, la masa final de las muestras
es_3XC1O3LBOUZZAPNJUBQK8V2FSBMLTY	Primero, me gustaria saber cual es la hipótesis del experimento. Segundo, tendría que saber cuánto vinagre poner a cada recipiente. Tercero, tendría que saber por cuánto tiempo enjuagar cada muestra con agua destilada.
es_3XCC1ODXDNOXL7Q4IRTLP20RFKSQR8	1. Una descripción de los objetivos y/o hipótesis del experimento.\n2. Una lista de los materiales requeridos incluidas muestras.\n3. Saber en que entorno se debe hacer el experimento, ya sea en un lugar abierto, en un laboratorio.\n4. Las precauciones que se deben tomar.
es_3XM0HYN6NMCNCRKKW8UWQQBYVCREPT	Origen y caracteristicas de las muestras: que tipo de madera, que tipo de plastico.\nTipo de vinagre (acidez)\nTapar o no los recipientes
es_3XUHV3NRVMBV3RT32UTODN3UR8CH5B	Yo necesitaría la cantidad de vinagre que se utilizó. También, necesitaría saber la temperatura de los recipientes durante las 24 horas. Al final, se necesita ambos los volúmenes de las muestras antes del experimento y después del experimento.
es_3YGXWBAF72UMQ0EN2XWDX400F3R4C2	Para replicar el experimento me faltaría saber cuánto vinagre se debe usar. ¿Debe cubrir completamente la muestra? También no se especifica qué forma tienen las muestras y eso afecta el área de contacto con el vinagre, ¿cada muestra es un sólo bloque de material o son varios pedacitos? Y por último, hace falta saber qué tipo de vinagre se debe usar, no me es claro que cualquier vinagre funcione igual.
es_3YHH42UU5DSYUGQSW92AOK0A1ZKL0L	determinar la acidez del vinagre y como puede corroer el material nprobar la pureza y dureza de los materialesnmedir la temperatura en la cual se realizan las pruebas
es_3YHH42UU5DSYUGQSW92AOK0AR0AL03	TIPO DE MATERIAL\nCANTIDAD DE VINAGRE UTILIZADA\nMÉTODO DE SECADO
es_3YJ6NA41JDTVN76CA95NN6OQWHVPJN	necesitaria los resultados del primer experiemento , una medidad de medicion para medir el peso exacto de cada muestra, necesitaria fotos de como fue el resutlado en el primer experimento
es_3YMTUJH0DUT3CHGYOJR3ME04C8LT4F	¿Qué tipo de vinagre era? ¿Cuánto vinagre se ha echado? ¿Dimensiones del recipiente? ¿Hay que cubrir en su totalidad las muestras? ¿Temperatura ambiente? ¿Que tipo de plástico? ¿Y de madera? ¿Y de caliza? ¿Y de mármol?
es_3YZ8UPK3VVZL7Y82H3NVA8YUEE3UCZ	Saber las condiciones atmosféricas, cantindad de vinagre en comparación con el peso del material y precision de los materiales de medida
es_3YZ8UPK3VVZL7Y82H3NVA8YUM6MUCA	En las muestras se a notado que hubo una estabilidad sin ninguna alteración como lo iso la madera no hubo cambio en su masa. nPero en las otras muestras si hubo alteración en su masa
es_3Z3ZLGNNSK75255271SP74XB64X3QV	cantidad inicial y final de vinagre en cada recipiente. tamaño del recipiente. ¿Está el material cubierto en su totalidad?
es_3Z3ZLGNNSK75255271SP74XBDIX3QU	madera
es_3Z3ZLGNNSK75255271SP74XBDNU3Q1	¿Cuanta cantidad de vinagre? Hasta sumergir la muestra? Se debería pesar el volumen liquido de vinagre.
es_3Z4AIRP3C8QT1ZSZ6B9YDJE75MQ1XG	- Cuanta vinagre echar en los recipientes\n- De que vinagra se trata (de manzana, de arándanos..)\n- El tamaño de los recipientes
es_3Z4GS9HPNXNDX61ADEM9KUSW5YF77T	Nesecitaria el tipo de madera que se ultilizo por ejemplo pino, roble o otro. \nLo mismo para el tipo de plactico que se uso si plastico como una bolsa o otro tipo. \nTambien nesecitaria la temperatura en la cual estuvo cada experimento al tiempo o si hubo algun tipo de calentamiento
es_3Z4XG4ZF4A4BCZCK5WIDST1FHAQX8O	la madera es mejor masa le sigue el marmol ysigue la caliza
es_3Z4XG4ZF4A4BCZCK5WIDST1FKJ6X8P	Necesitaría saber: Las características químicas del vinagre, el material de los recipientes, y si estos fueron sellados durante el proceso de las 24 horas de espera, así como la composición específica de cada muestra (madera de qué tipo? Plástico de qué tipo? etc)
es_3Z7VU45IP0UI6USE7TXJA4UIE7IZ1C	1. Necesitaria saber si las masas fueron solidas o en polvo.\n2. Necesito la temperatura del cuarto donde las muestras estuvieron restando las 24 horas y cuando se secaban\n3. Que se ocupo de filtro a enjuagarlas? Para ver si era posible que materias se escaparon al enjuagarlas.\n4. Con cuanta agua destilada se enjugaron? Un litro? 50 litros?
es_3Z9WI9EOZ11YLAE69HXUFCMCWMSHK1	Necesito las medidas de los cuatro recipientes, cuánto vinagre se usó, en qué tipo de superficie se secaron las muestras.
es_3ZPBJO59KREQ748WH0B7BZRM9LPDHR	1.  Necesitamos saber que cantidad de vinagre usaron.\n2.  Necesitamos saber cual es el area de superficie de las muestras.\n3.  Necesitamos saber si el vinagre cubre la muestra completamente.
es_3ZPPDN2SLX92K44DFJYZ40BJL7TE9B	Dejar las muestras reposar y secar durante masa final
es_3ZPPDN2SLX92K44DFJYZ40BJLFTE9R	el tiempo , cuanto vinagre fue usado,y cuanta masa fue usada
es_3ZPPDN2SLX92K44DFJYZ40BJLII9EH	saber la cantidad de vinagre que hay que poner y dónde se va a almacenar, temperatura etc
es_3ZQIG0FLQGTUYB373KX1IO7GT24VWJ	1. Que cantidad de agua destilada se utilizó para el experimento?n2. Que clase de vinagre fue utilizado para el experimento?n3. Que cantidad de vinagre utilizó para el experimento?n4. Qué recipiente usaron para las muestras?n5. A donde dejaron que las muestras se secarán? En el sol? En un aula? n6. Se secaron todas las muestras al mismo tiempo? Dependiendo del material de la muestra puede que se hayan secado a un ritmo mas lento o mas rapido.
es_3ZR9AIQJUDM2W8J7QH3T23YZ9KT04J	Los estudiantes podrían hacer los mismos procedimientos del experimento con diferentes tres materiales diferentes: como algodón, hierro, y bicarbonato de sodio.
es_3ZSANO2JCHKCVX08J0IW3D19X9NFST	Para replicar el experimento, hay que poner el agua y el vinagre a la misma vez porque uno no sabe si la diferencia es de el agua o el vinagre. También, sería útil usar masa diferente por saber que es la masa y que es la muestra. Además, uno debería usar muestras que pesan igual al principio.
es_3ZSY5X72NZOU0VDO3E1H0X5R44XORV	Según mi conocimiento, creo que se requieren los siguientes datos.nn1. Cantidad de vinagre utilizado para cada muestra.n2. Volumen de contenedores utilizados.n3. Volumen de agua destilada utilizada.n4. Temperatura a la que se mantuvieron esas muestras durante 24 horas.n5. También es importante mencionar si las muestras se mantuvieron secas durante 30 minutos a temperatura ambiente o en un lugar seco sin entrada de aire.
es_3ZY8KE4ISLGPEE7LRBYVQZPU3PJVQL	Determinar la masa da cada muestra
es_3ZY8KE4ISLGPEE7LRBYVQZPUV6VQVI	-Tipo de vinagre utilizado(ph  del vinagre)\n-Tipo de madera y plastico utilizados(existen diferentes tipos de madera y plastico)\n-geometria de la muestra(fueron todas las muestras de la misma geometria?, prisma, esfera, etc..)
